"a" = (/turf/simulated/wall/r_wall,/area/template_noop)
"b" = (/obj/structure/filingcabinet,/obj/effect/decal/cleanable/cobweb,/turf/simulated/floor/tiled/dark/techfloor,/area/template_noop)
"c" = (/obj/structure/table/standard{flipped = 1},/obj/effect/spider/cocoon,/turf/simulated/floor/tiled/dark/techfloor,/area/template_noop)
"d" = (/obj/structure/table/standard{flipped = 1},/obj/structure/closet/crate/secure/loot,/obj/item/weapon/paper,/turf/simulated/floor/tiled/dark/techfloor,/area/template_noop)
"e" = (/obj/structure/table/standard{flipped = 1},/obj/item/weapon/pen,/obj/effect/spider/stickyweb,/turf/simulated/floor/tiled/dark/techfloor,/area/template_noop)
"f" = (/obj/structure/barricade,/turf/simulated/floor/plating,/area/template_noop)
"g" = (/obj/structure/filingcabinet,/turf/simulated/floor/tiled/dark/techfloor,/area/template_noop)
"h" = (/obj/structure/grille,/turf/simulated/floor/plating,/area/template_noop)
"i" = (/obj/machinery/seed_storage/random,/turf/simulated/floor/tiled/dark/techfloor,/area/template_noop)
"j" = (/obj/item/weapon/paper,/turf/simulated/floor/tiled/dark/techfloor,/area/template_noop)
"k" = (/obj/item/weapon/pen,/obj/effect/spider/stickyweb,/obj/effect/decal/cleanable/blood/drip,/turf/simulated/floor/tiled/dark/techfloor,/area/template_noop)
"l" = (/obj/effect/decal/cleanable/blood,/turf/simulated/floor/tiled/dark/techfloor,/area/template_noop)
"m" = (/turf/template_noop,/area/template_noop)
"n" = (/obj/effect/spider/stickyweb,/obj/item/weapon/paper,/turf/simulated/floor/tiled/dark/techfloor,/area/template_noop)
"o" = (/obj/item/weapon/paper_bin,/obj/effect/spider/stickyweb,/turf/simulated/floor/tiled/dark/techfloor,/area/template_noop)
"p" = (/obj/structure/bookcase/manuals/research_and_development,/obj/effect/decal/cleanable/cobweb2,/turf/simulated/floor/tiled/dark/techfloor,/area/template_noop)
"q" = (/obj/item/weapon/melee/telebaton,/obj/item/seeds/random,/obj/effect/decal/cleanable/spiderling_remains,/obj/structure/fireaxecabinet{pixel_x = -32},/turf/simulated/floor/tiled/dark/techfloor,/area/template_noop)
"r" = (/obj/effect/spider/stickyweb,/obj/item/seeds/random,/turf/simulated/floor/tiled/dark/techfloor,/area/template_noop)
"s" = (/turf/simulated/floor/tiled/dark/techfloor,/area/template_noop)
"t" = (/obj/effect/decal/cleanable/blood,/obj/item/weapon/paper,/obj/structure/closet/crate/secure/loot,/obj/spawner/mob/spiders/cluster,/turf/simulated/floor/tiled/dark/techfloor,/area/template_noop)
"u" = (/obj/effect/spider/stickyweb,/obj/effect/decal/cleanable/blood/drip,/obj/effect/decal/cleanable/blood/drip,/turf/simulated/floor/tiled/dark/techfloor,/area/template_noop)
"v" = (/obj/effect/spider/stickyweb,/turf/simulated/floor/tiled/dark/techfloor,/area/template_noop)
"w" = (/obj/structure/closet/crate/secure/loot,/turf/simulated/floor/tiled/dark/techfloor,/area/template_noop)
"x" = (/obj/structure/grille/broken,/obj/effect/spider/stickyweb,/obj/effect/decal/cleanable/blood/gibs/limb,/obj/effect/decal/cleanable/blood/drip,/turf/simulated/floor/plating,/area/template_noop)
"y" = (/obj/effect/spider/stickyweb,/obj/spawner/voidsuit,/obj/structure/closet/crate/secure/loot,/obj/effect/decal/cleanable/vomit,/obj/structure/extinguisher_cabinet{pixel_x = -32},/turf/simulated/floor/tiled/dark/techfloor,/area/template_noop)
"z" = (/obj/effect/decal/cleanable/spiderling_remains,/obj/effect/decal/cleanable/blood,/turf/simulated/floor/tiled/dark/techfloor,/area/template_noop)
"A" = (/obj/structure/closet/crate/secure/loot,/turf/template_noop,/area/template_noop)
"B" = (/obj/effect/spider/stickyweb,/obj/effect/decal/cleanable/blood/drip,/turf/simulated/floor/tiled/dark/techfloor,/area/template_noop)
"C" = (/obj/effect/decal/cleanable/blood/drip,/turf/simulated/floor/tiled/dark/techfloor,/area/template_noop)
"D" = (/obj/item/weapon/paper,/obj/effect/decal/cleanable/blood/drip,/turf/simulated/floor/tiled/dark/techfloor,/area/template_noop)
"E" = (/obj/effect/spider/stickyweb,/obj/effect/spider/cocoon,/obj/structure/closet/crate/secure/loot,/turf/simulated/floor/reinforced,/area/template_noop)
"F" = (/obj/effect/decal/cleanable/blood/splatter,/obj/landmark/corpse/doctor,/turf/simulated/floor/tiled/dark/techfloor,/area/template_noop)
"G" = (/obj/structure/grille/broken,/obj/effect/spider/stickyweb,/obj/effect/decal/cleanable/blood/drip,/turf/simulated/floor/plating,/area/template_noop)
"H" = (/obj/machinery/door/airlock/external,/turf/simulated/floor/tiled/dark/techfloor,/area/template_noop)
"I" = (/obj/structure/grille/broken,/obj/effect/decal/cleanable/blood,/obj/structure/closet/crate/secure/loot,/obj/spawner/pack/gun_loot,/obj/spawner/pack/gun_loot,/turf/simulated/floor/plating,/area/template_noop)
"J" = (/obj/structure/closet/crate/secure/loot,/obj/effect/spider/stickyweb,/obj/effect/decal/cleanable/blood/gibs/limb,/obj/effect/decal/cleanable/blood/drip,/obj/spawner/mob/spiders/cluster,/turf/simulated/floor/reinforced,/area/template_noop)
"K" = (/obj/effect/decal/cleanable/blood/gibs/body,/turf/simulated/floor/reinforced,/area/template_noop)
"L" = (/obj/effect/decal/cleanable/blood,/obj/item/weapon/material/shard,/obj/effect/decal/cleanable/blood/drip,/obj/effect/decal/cleanable/vomit,/turf/simulated/floor/tiled/dark/techfloor,/area/template_noop)
"M" = (/obj/effect/decal/cleanable/blood,/turf/template_noop,/area/template_noop)
"N" = (/obj/effect/spider/stickyweb,/obj/effect/decal/cleanable/blood/drip,/obj/spawner/mob/spiders/cluster,/turf/simulated/floor/reinforced,/area/template_noop)
"O" = (/obj/effect/decal/cleanable/spiderling_remains,/turf/template_noop,/area/template_noop)
"P" = (/obj/effect/decal/cleanable/blood/drip,/turf/template_noop,/area/template_noop)
"Q" = (/obj/effect/spider/stickyweb,/obj/machinery/door/airlock/external,/turf/simulated/floor/tiled/dark/techfloor,/area/template_noop)

(1,1,1) = {"
maafffaam
aabcdegaa
aijklnopa
aqrstuvwa
ayzvBCDFa
ahxaHaGIa
aKJaLaNEa
aaaaQaaaa
mmmMPAOmm
"}
