//MAP CONVERTED BY dmm2tgm.py THIS HEADER COMMENT PREVENTS RECONVERSION, DO NOT REMOVE
"a" = (
/turf/simulated/floor/tiled/dark/gray_perforated,
/area/deepmaint)
"b" = (
/obj/machinery/light/small,
/turf/simulated/floor/tiled/dark/gray_perforated,
/area/deepmaint)
"c" = (
/turf/simulated/wall,
/area/deepmaint)
"d" = (
/obj/effect/window_lwall_spawn,
/turf/simulated/floor/plating,
/area/deepmaint)
"e" = (
/obj/effect/decal/cleanable/dirt,
/turf/simulated/floor/tiled/dark/gray_perforated,
/area/deepmaint)
"f" = (
/obj/effect/window_lwall_spawn,
/turf/simulated/floor/tiled/techmaint,
/area/deepmaint)
"h" = (
/obj/effect/decal/cleanable/dirt,
/obj/effect/decal/cleanable/dirt,
/obj/machinery/door/airlock/maintenance_common,
/obj/spawner/traps,
/obj/spawner/junk/low_chance,
/turf/simulated/floor/tiled/techmaint,
/area/deepmaint)
"i" = (
/obj/effect/decal/cleanable/dirt,
/obj/effect/decal/cleanable/dirt,
/obj/spawner/traps/low_chance,
/obj/spawner/junk/low_chance,
/turf/simulated/floor/tiled/steel,
/area/deepmaint)
"l" = (
/obj/effect/decal/cleanable/dirt,
/obj/structure/catwalk,
/obj/spawner/traps,
/obj/spawner/junk/low_chance,
/turf/simulated/floor/plating/under,
/area/deepmaint)
"m" = (
/obj/effect/decal/cleanable/dirt,
/obj/structure/catwalk,
/obj/item/clothing/accessory/medal/gold/captain,
/turf/simulated/floor/plating/under,
/area/deepmaint)
"n" = (
/obj/effect/decal/cleanable/dirt,
/obj/effect/decal/cleanable/dirt,
/obj/structure/catwalk,
/obj/item/remains/human,
/obj/item/clothing/gloves/captain,
/obj/item/clothing/under/captainformal,
/turf/simulated/floor/plating/under,
/area/deepmaint)
"o" = (
/obj/spawner/traps/low_chance,
/obj/spawner/junk/low_chance,
/turf/simulated/floor/tiled/techmaint,
/area/deepmaint)
"p" = (
/obj/effect/decal/cleanable/dirt,
/obj/spawner/traps/low_chance,
/obj/spawner/junk/low_chance,
/turf/simulated/floor/tiled/techmaint,
/area/deepmaint)
"q" = (
/obj/effect/decal/cleanable/dirt,
/obj/structure/catwalk,
/obj/item/modular_computer/pda/captain,
/turf/simulated/floor/plating/under,
/area/deepmaint)
"r" = (
/obj/effect/decal/cleanable/dirt,
/obj/spawner/traps/low_chance,
/obj/spawner/junk/low_chance,
/turf/simulated/floor/tiled/steel,
/area/deepmaint)
"s" = (
/obj/effect/decal/cleanable/dirt,
/obj/spawner/scrap,
/turf/simulated/floor/tiled/techmaint,
/area/deepmaint)
"t" = (
/obj/effect/decal/cleanable/dirt,
/obj/spawner/scrap/dense/low_chance,
/turf/simulated/floor/tiled/techmaint,
/area/deepmaint)
"u" = (
/obj/effect/decal/cleanable/dirt,
/obj/spawner/scrap/dense/low_chance,
/turf/simulated/floor/tiled/dark/gray_perforated,
/area/deepmaint)
"v" = (
/obj/machinery/light/small{
	dir = 4;
	pixel_y = 0
	},
/obj/spawner/scrap/dense,
/turf/simulated/floor/tiled/steel,
/area/deepmaint)
"w" = (
/obj/machinery/door/airlock/maintenance_common,
/turf/simulated/floor/tiled/techmaint,
/area/deepmaint)
"x" = (
/obj/machinery/door/airlock/maintenance_common,
/obj/effect/decal/cleanable/dirt,
/obj/spawner/traps,
/turf/simulated/floor/tiled/techmaint,
/area/deepmaint)
"y" = (
/obj/effect/decal/cleanable/dirt,
/obj/spawner/junk,
/turf/simulated/floor/tiled/techmaint,
/area/deepmaint)
"z" = (
/obj/effect/decal/cleanable/dirt,
/obj/effect/decal/cleanable/dirt,
/obj/spawner/scrap,
/turf/simulated/floor/tiled/techmaint,
/area/deepmaint)
"A" = (
/obj/structure/catwalk,
/obj/item/gun/energy/plasma/brigador,
/turf/simulated/floor/plating/under,
/area/deepmaint)
"B" = (
/obj/effect/decal/cleanable/dirt,
/obj/spawner/mob/roaches/cluster,
/turf/simulated/floor/tiled/dark/gray_perforated,
/area/deepmaint)
"C" = (
/obj/effect/decal/cleanable/dirt,
/obj/spawner/traps,
/obj/spawner/junk/low_chance,
/turf/simulated/floor/tiled/steel,
/area/deepmaint)
"D" = (
/obj/spawner/traps/low_chance,
/obj/spawner/junk/low_chance,
/turf/simulated/floor/tiled/steel,
/area/deepmaint)
"L" = (
/obj/effect/decal/cleanable/dirt,
/obj/effect/decal/cleanable/dirt,
/obj/spawner/traps/low_chance,
/obj/spawner/junk,
/turf/simulated/floor/tiled/steel,
/area/deepmaint)
"N" = (
/obj/spawner/junk,
/turf/simulated/floor/tiled/dark/gray_perforated,
/area/deepmaint)
"O" = (
/obj/effect/decal/cleanable/dirt,
/obj/spawner/scrap/dense,
/turf/simulated/floor/tiled/techmaint,
/area/deepmaint)
"Q" = (
/obj/effect/decal/cleanable/dirt,
/obj/spawner/scrap/dense,
/turf/simulated/floor/tiled/steel,
/area/deepmaint)
"R" = (
/obj/effect/decal/cleanable/dirt,
/obj/spawner/junk,
/turf/simulated/floor/tiled/dark/gray_perforated,
/area/deepmaint)
"T" = (
/obj/structure/catwalk,
/obj/structure/table/rack/shelf,
/turf/simulated/floor/plating/under,
/area/deepmaint)
"W" = (
/obj/machinery/light/small{
	dir = 4;
	pixel_y = 0
	},
/turf/simulated/floor/tiled/techmaint,
/area/deepmaint)
"Z" = (
/obj/machinery/door/airlock/maintenance_common,
/obj/effect/decal/cleanable/dirt,
/turf/simulated/floor/tiled/techmaint,
/area/deepmaint)

(1,1,1) = {"
a
e
a
a
a
e
N
e
a
a
a
"}
(2,1,1) = {"
a
c
d
c
c
c
c
c
c
c
e
"}
(3,1,1) = {"
e
c
i
r
Q
r
D
C
Q
x
a
"}
(4,1,1) = {"
a
c
r
v
L
D
Q
r
r
Z
R
"}
(5,1,1) = {"
a
c
h
c
w
c
c
c
f
c
a
"}
(6,1,1) = {"
a
c
l
c
o
p
o
c
s
O
a
"}
(7,1,1) = {"
b
c
m
c
c
o
p
c
t
y
a
"}
(8,1,1) = {"
e
c
n
A
c
o
o
c
O
z
a
"}
(9,1,1) = {"
a
c
q
T
c
W
c
c
u
a
a
"}
(10,1,1) = {"
a
c
c
c
c
c
c
u
B
a
N
"}
(11,1,1) = {"
a
a
a
a
a
a
a
a
e
a
a
"}
