//MAP CONVERTED BY dmm2tgm.py THIS HEADER COMMENT PREVENTS RECONVERSION, DO NOT REMOVE
"a" = (
/obj/structure/disposalpipe/segment{
	dir = 1;
	icon_state = "pipe-c"
	},
/obj/machinery/atmospherics/pipe/simple/hidden/supply{
	dir = 4
	},
/obj/machinery/atmospherics/pipe/simple/hidden/scrubbers{
	dir = 4
	},
/turf/simulated/floor/tiled/steel,
/area/deepmaint)
"b" = (
/turf/simulated/floor/tiled/dark/panels,
/area/deepmaint)
"c" = (
/turf/simulated/wall,
/area/deepmaint)
"d" = (
/obj/structure/table/standard,
/obj/spawner/rations/low_chance,
/obj/machinery/newscaster{
	pixel_y = 30
	},
/turf/simulated/floor/plating,
/area/deepmaint)
"e" = (
/obj/machinery/light,
/obj/machinery/flasher{
	id = "Cell 3";
	pixel_y = -28
	},
/turf/simulated/floor/plating,
/area/deepmaint)
"f" = (
/obj/structure/bed/chair/sofa/purp{
	dir = 8
	},
/obj/machinery/atmospherics/unary/vent_pump/on{
	dir = 8
	},
/turf/simulated/floor/tiled/dark/danger,
/area/deepmaint)
"l" = (
/obj/structure/disposalpipe/segment{
	dir = 4
	},
/obj/machinery/atmospherics/pipe/manifold/hidden/supply,
/obj/machinery/atmospherics/pipe/manifold/hidden/scrubbers,
/turf/simulated/floor/tiled/steel,
/area/deepmaint)
"m" = (
/obj/structure/table/standard,
/obj/spawner/booze/low_chance,
/obj/machinery/light/small{
	dir = 1
	},
/obj/machinery/alarm{
	pixel_y = 26
	},
/turf/simulated/floor/plating,
/area/deepmaint)
"n" = (
/obj/structure/disposalpipe/segment,
/obj/machinery/atmospherics/pipe/simple/hidden/supply,
/obj/machinery/atmospherics/pipe/simple/hidden/scrubbers,
/turf/simulated/floor/tiled/steel,
/area/deepmaint)
"p" = (
/obj/structure/table/standard,
/obj/spawner/rations/low_chance,
/turf/simulated/floor/plating,
/area/deepmaint)
"q" = (
/obj/machinery/atmospherics/unary/vent_scrubber/on,
/obj/structure/curtain/black,
/turf/simulated/floor/plating/under,
/area/deepmaint)
"r" = (
/obj/structure/bed/chair/sofa/purp/corner{
	dir = 1
	},
/turf/simulated/floor/tiled/dark/danger,
/area/deepmaint)
"u" = (
/turf/simulated/floor/plating,
/area/deepmaint)
"w" = (
/turf/simulated/floor/plating/under,
/area/deepmaint)
"z" = (
/turf/simulated/wall/r_wall,
/area/deepmaint)
"A" = (
/obj/structure/curtain/black,
/turf/simulated/floor/tiled/dark/techfloor_grid,
/area/deepmaint)
"B" = (
/obj/structure/curtain/black,
/obj/machinery/atmospherics/pipe/simple/hidden/supply,
/obj/machinery/atmospherics/pipe/simple/hidden/scrubbers,
/turf/simulated/floor/plating,
/area/deepmaint)
"C" = (
/obj/machinery/light/small{
	dir = 8
	},
/obj/structure/table/standard,
/obj/spawner/booze/low_chance,
/turf/simulated/floor/plating,
/area/deepmaint)
"D" = (
/obj/structure/bed/chair/sofa/purp/right{
	dir = 4
	},
/turf/simulated/floor/tiled/dark/danger,
/area/deepmaint)
"E" = (
/obj/machinery/light,
/obj/structure/curtain/black,
/turf/simulated/floor/tiled/steel,
/area/deepmaint)
"F" = (
/obj/structure/disposalpipe/segment{
	dir = 4
	},
/obj/machinery/atmospherics/pipe/simple/hidden/supply{
	dir = 4
	},
/obj/machinery/atmospherics/pipe/simple/hidden/scrubbers{
	dir = 4
	},
/turf/simulated/floor/tiled/steel,
/area/deepmaint)
"G" = (
/obj/structure/table/standard,
/obj/spawner/booze/low_chance,
/obj/machinery/light/small{
	dir = 4
	},
/turf/simulated/floor/plating,
/area/deepmaint)
"H" = (
/obj/machinery/disposal,
/obj/structure/disposalpipe/trunk,
/turf/simulated/floor/plating/under,
/area/deepmaint)
"J" = (
/obj/structure/curtain/black,
/turf/simulated/floor/tiled/steel,
/area/deepmaint)
"K" = (
/obj/item/stool/padded,
/obj/item/toy/plushie/soygel,
/obj/machinery/atmospherics/pipe/simple/hidden/supply{
	dir = 6
	},
/obj/machinery/atmospherics/pipe/simple/hidden/scrubbers{
	dir = 10
	},
/turf/simulated/floor/tiled/dark/techfloor_grid,
/area/deepmaint)
"L" = (
/obj/machinery/light,
/turf/simulated/floor/tiled/steel,
/area/deepmaint)
"M" = (
/obj/structure/disposalpipe/segment,
/obj/machinery/atmospherics/pipe/simple/hidden/supply,
/obj/machinery/atmospherics/pipe/simple/hidden/scrubbers,
/turf/simulated/floor/tiled/dark/panels,
/area/deepmaint)
"N" = (
/obj/structure/bed/chair/sofa/purp/corner,
/turf/simulated/floor/tiled/dark/danger,
/area/deepmaint)
"O" = (
/obj/machinery/atmospherics/pipe/simple/hidden/supply,
/obj/machinery/atmospherics/pipe/simple/hidden/scrubbers,
/turf/simulated/floor/tiled/dark/danger,
/area/deepmaint)
"P" = (
/obj/machinery/atmospherics/pipe/simple/hidden/supply{
	dir = 4
	},
/obj/machinery/atmospherics/pipe/simple/hidden/scrubbers{
	dir = 5
	},
/obj/structure/curtain/black,
/turf/simulated/floor/tiled/steel,
/area/deepmaint)
"Q" = (
/obj/structure/disposalpipe/segment{
	dir = 4
	},
/obj/machinery/atmospherics/pipe/simple/hidden/supply{
	dir = 4
	},
/obj/machinery/atmospherics/pipe/simple/hidden/scrubbers{
	dir = 4
	},
/obj/machinery/atm{
	pixel_y = 24
	},
/turf/simulated/floor/tiled/steel,
/area/deepmaint)
"R" = (
/obj/structure/disposalpipe/junction{
	dir = 4
	},
/obj/machinery/atmospherics/pipe/manifold/hidden/scrubbers{
	dir = 1
	},
/obj/machinery/atmospherics/pipe/manifold/hidden/supply{
	dir = 1
	},
/turf/simulated/floor/tiled/steel,
/area/deepmaint)
"S" = (
/turf/simulated/floor/tiled/steel,
/area/deepmaint)
"T" = (
/obj/structure/disposalpipe/segment{
	dir = 4
	},
/obj/machinery/atmospherics/pipe/simple/hidden/supply{
	dir = 4
	},
/obj/machinery/atmospherics/pipe/simple/hidden/scrubbers{
	dir = 4
	},
/obj/structure/curtain/black,
/turf/simulated/floor/tiled/steel,
/area/deepmaint)
"U" = (
/obj/structure/bed/chair/sofa/purp,
/turf/simulated/floor/tiled/dark/danger,
/area/deepmaint)
"V" = (
/obj/structure/bed/chair/sofa/purp{
	dir = 4
	},
/obj/machinery/atmospherics/unary/vent_scrubber/on{
	dir = 4
	},
/turf/simulated/floor/tiled/dark/danger,
/area/deepmaint)
"W" = (
/obj/structure/curtain/black,
/turf/simulated/floor/plating,
/area/deepmaint)
"X" = (
/obj/structure/bed/chair/sofa/purp/left{
	dir = 8
	},
/turf/simulated/floor/tiled/dark/danger,
/area/deepmaint)
"Y" = (
/obj/machinery/light{
	dir = 1
	},
/obj/structure/disposalpipe/segment{
	dir = 4
	},
/obj/machinery/atmospherics/pipe/simple/hidden/supply{
	dir = 4
	},
/obj/machinery/atmospherics/pipe/simple/hidden/scrubbers{
	dir = 4
	},
/turf/simulated/floor/tiled/steel,
/area/deepmaint)
"Z" = (
/obj/effect/window_lwall_spawn/reinforced,
/obj/structure/curtain/black,
/turf/simulated/floor/plating/under,
/area/deepmaint)

(1,1,1) = {"
u
u
u
w
w
w
c
q
P
J
c
"}
(2,1,1) = {"
u
u
e
z
w
w
z
H
a
S
W
"}
(3,1,1) = {"
w
u
z
z
z
z
z
c
Q
S
W
"}
(4,1,1) = {"
w
u
z
z
p
C
p
c
Y
L
c
"}
(5,1,1) = {"
w
u
c
p
r
V
D
Z
R
n
M
"}
(6,1,1) = {"
w
u
c
m
U
K
O
B
l
S
b
"}
(7,1,1) = {"
w
u
c
d
N
f
X
Z
F
L
c
"}
(8,1,1) = {"
w
u
c
c
p
G
p
c
Y
S
c
"}
(9,1,1) = {"
w
u
c
c
c
c
c
c
F
S
A
"}
(10,1,1) = {"
u
u
u
u
u
u
u
u
F
S
W
"}
(11,1,1) = {"
w
w
w
w
w
w
w
c
T
E
c
"}
