//MAP CONVERTED BY dmm2tgm.py THIS HEADER COMMENT PREVENTS RECONVERSION, DO NOT REMOVE
"a" = (
/obj/structure/disposalpipe/segment,
/turf/simulated/floor/wood,
/area/deepmaint)
"b" = (
/obj/structure/low_wall,
/obj/structure/curtain/darkblue,
/obj/structure/cyberplant,
/turf/simulated/floor/plating,
/area/deepmaint)
"c" = (
/turf/simulated/wall,
/area/deepmaint)
"d" = (
/obj/structure/table/glass,
/turf/simulated/floor/tiled/cafe,
/area/deepmaint)
"e" = (
/obj/landmark/join/start/clubworker,
/turf/simulated/floor/tiled/cafe,
/area/deepmaint)
"f" = (
/obj/structure/disposalpipe/segment{
	dir = 4
	},
/turf/simulated/floor/tiled/steel,
/area/deepmaint)
"g" = (
/turf/simulated/floor/tiled/steel,
/area/deepmaint)
"j" = (
/turf/simulated/floor/tiled/steel/gray_perforated,
/area/deepmaint)
"k" = (
/obj/structure/bed/chair/sofa/black/right{
	dir = 4
	},
/obj/machinery/atmospherics/unary/vent_scrubber/on{
	dir = 8
	},
/turf/simulated/floor/carpet/blucarpet,
/area/deepmaint)
"l" = (
/obj/machinery/firealarm{
	pixel_y = 28
	},
/turf/simulated/floor/tiled/cafe,
/area/deepmaint)
"n" = (
/obj/structure/cable/green{
	d1 = 4;
	d2 = 8;
	icon_state = "4-8"
	},
/turf/simulated/floor/tiled/steel,
/area/deepmaint)
"o" = (
/obj/structure/disposalpipe/segment{
	dir = 4
	},
/turf/simulated/floor/wood,
/area/deepmaint)
"p" = (
/obj/item/stool/custom/bar_special,
/turf/simulated/floor/wood,
/area/deepmaint)
"q" = (
/turf/simulated/floor/tiled/cafe,
/area/deepmaint)
"r" = (
/turf/simulated/floor/tiled/dark/gray_perforated,
/area/deepmaint)
"s" = (
/obj/structure/cable/green{
	d1 = 4;
	d2 = 8;
	icon_state = "4-8"
	},
/turf/simulated/floor/tiled/white/gray_platform,
/area/deepmaint)
"t" = (
/obj/machinery/light{
	dir = 8
	},
/obj/machinery/power/apc{
	dir = 8;
	name = "West APC";
	pixel_x = -28
	},
/obj/structure/cable/green{
	d2 = 2;
	icon_state = "0-2"
	},
/turf/simulated/floor/wood,
/area/deepmaint)
"u" = (
/obj/spawner/scrap/dense,
/turf/simulated/floor/tiled/steel/gray_perforated,
/area/deepmaint)
"v" = (
/obj/structure/table/glass,
/turf/simulated/floor/carpet/blucarpet,
/area/deepmaint)
"w" = (
/obj/effect/decal/cleanable/dirt,
/turf/simulated/floor/tiled/steel/gray_perforated,
/area/deepmaint)
"x" = (
/obj/structure/bed/chair/sofa/black/right{
	dir = 4
	},
/obj/machinery/atmospherics/unary/vent_scrubber/on{
	dir = 8
	},
/obj/machinery/alarm{
	dir = 1;
	pixel_y = -22
	},
/turf/simulated/floor/carpet/blucarpet,
/area/deepmaint)
"z" = (
/obj/machinery/door/airlock/multi_tile/glass{
	dir = 2
	},
/obj/structure/disposalpipe/segment{
	dir = 4
	},
/turf/simulated/floor/tiled/white/gray_platform,
/area/deepmaint)
"A" = (
/obj/structure/table/glass,
/obj/machinery/chemical_dispenser/soda,
/turf/simulated/floor/tiled/cafe,
/area/deepmaint)
"B" = (
/obj/structure/table/glass,
/obj/structure/disposalpipe/junction{
	dir = 8;
	icon_state = "pipe-j2"
	},
/turf/simulated/floor/tiled/cafe,
/area/deepmaint)
"C" = (
/obj/item/stool/custom/bar_special,
/obj/structure/disposalpipe/segment{
	dir = 4
	},
/turf/simulated/floor/wood,
/area/deepmaint)
"D" = (
/obj/structure/curtain/darkblue,
/turf/simulated/floor/wood,
/area/deepmaint)
"E" = (
/obj/structure/table/glass,
/obj/machinery/camera/network/second_section{
	dir = 8
	},
/obj/structure/disposalpipe/segment{
	dir = 8;
	icon_state = "pipe-c"
	},
/turf/simulated/floor/tiled/cafe,
/area/deepmaint)
"F" = (
/obj/effect/window_lwall_spawn/smartspawn,
/obj/machinery/atmospherics/pipe/simple/hidden/supply{
	dir = 4
	},
/turf/simulated/floor/plating,
/area/deepmaint)
"G" = (
/obj/effect/window_lwall_spawn/smartspawn,
/obj/machinery/atmospherics/pipe/simple/hidden/scrubbers{
	dir = 4
	},
/turf/simulated/floor/plating,
/area/deepmaint)
"H" = (
/obj/machinery/light{
	dir = 1
	},
/obj/machinery/alarm{
	pixel_y = 26
	},
/turf/simulated/floor/wood,
/area/deepmaint)
"I" = (
/obj/structure/low_wall,
/obj/structure/curtain/darkblue,
/turf/simulated/floor/plating,
/area/deepmaint)
"J" = (
/obj/structure/cyberplant,
/turf/simulated/floor/wood,
/area/deepmaint)
"K" = (
/obj/structure/cable/green{
	d1 = 1;
	d2 = 8;
	icon_state = "1-8"
	},
/turf/simulated/floor/wood,
/area/deepmaint)
"L" = (
/obj/machinery/atmospherics/pipe/simple/hidden/scrubbers{
	dir = 4
	},
/turf/simulated/floor/tiled/steel,
/area/deepmaint)
"M" = (
/obj/machinery/disposal,
/obj/structure/disposalpipe/trunk,
/turf/simulated/floor/tiled/cafe,
/area/deepmaint)
"N" = (
/obj/structure/low_wall,
/obj/structure/curtain/darkblue,
/obj/structure/cyberplant,
/obj/structure/cyberplant,
/turf/simulated/floor/plating,
/area/deepmaint)
"O" = (
/obj/structure/bed/chair/sofa/black/left{
	dir = 4
	},
/obj/machinery/atmospherics/unary/vent_pump/on{
	dir = 8
	},
/turf/simulated/floor/carpet/blucarpet,
/area/deepmaint)
"P" = (
/obj/machinery/vending/boozeomat,
/turf/simulated/floor/tiled/cafe,
/area/deepmaint)
"Q" = (
/obj/machinery/atmospherics/pipe/simple/hidden/supply{
	dir = 4
	},
/turf/simulated/floor/tiled/steel,
/area/deepmaint)
"R" = (
/obj/item/stool/custom/bar_special,
/obj/structure/disposalpipe/segment,
/turf/simulated/floor/wood,
/area/deepmaint)
"S" = (
/turf/simulated/floor/wood,
/area/deepmaint)
"T" = (
/obj/structure/table/glass,
/obj/structure/disposalpipe/segment{
	dir = 4
	},
/turf/simulated/floor/tiled/cafe,
/area/deepmaint)
"U" = (
/obj/machinery/light,
/obj/machinery/firealarm{
	dir = 1;
	pixel_y = -28
	},
/obj/machinery/disposal,
/obj/structure/disposalpipe/trunk{
	dir = 1
	},
/turf/simulated/floor/wood,
/area/deepmaint)
"V" = (
/obj/machinery/camera/network/second_section{
	dir = 8
	},
/turf/simulated/floor/tiled/steel,
/area/deepmaint)
"W" = (
/obj/machinery/alarm{
	dir = 8;
	pixel_x = 26
	},
/turf/simulated/floor/tiled/steel,
/area/deepmaint)
"X" = (
/obj/machinery/vending/dinnerware,
/obj/machinery/camera/network/second_section{
	dir = 8
	},
/turf/simulated/floor/tiled/cafe,
/area/deepmaint)
"Y" = (
/obj/structure/extinguisher_cabinet{
	pixel_y = 27
	},
/turf/simulated/floor/wood,
/area/deepmaint)
"Z" = (
/obj/machinery/light{
	dir = 8
	},
/obj/machinery/newscaster{
	pixel_x = -32
	},
/turf/simulated/floor/wood,
/area/deepmaint)

(1,1,1) = {"
g
W
Q
L
V
n
f
g
Q
L
g
"}
(2,1,1) = {"
r
c
F
G
c
s
z
c
F
G
c
"}
(3,1,1) = {"
w
c
O
k
t
K
o
Z
O
x
c
"}
(4,1,1) = {"
w
c
v
v
J
S
o
J
v
v
I
"}
(5,1,1) = {"
j
c
Y
S
S
S
o
S
S
S
N
"}
(6,1,1) = {"
u
c
H
p
p
p
C
S
S
S
D
"}
(7,1,1) = {"
u
c
l
d
d
d
B
R
a
U
c
"}
(8,1,1) = {"
j
c
q
e
e
q
T
p
S
S
D
"}
(9,1,1) = {"
w
c
P
X
A
M
E
p
S
S
b
"}
(10,1,1) = {"
w
c
c
c
c
c
c
c
c
c
c
"}
(11,1,1) = {"
j
r
r
r
r
r
r
r
r
r
r
"}
