"a" = (/turf/template_noop,/area/template_noop)
"b" = (/turf/simulated/wall,/area/template_noop)
"c" = (/obj/machinery/power/port_gen/pacman,/turf/simulated/floor/wood,/area/template_noop)
"d" = (/obj/structure/closet/cabinet,/obj/item/clothing/under/color/black,/obj/item/clothing/mask/breath,/obj/spawner/cloth/armor,/obj/spawner/cloth/belt,/obj/spawner/cloth/gloves,/obj/spawner/cloth/helmet,/obj/spawner/cloth/holster,/obj/spawner/cloth/masks,/obj/spawner/cloth/shoes,/obj/spawner/cloth/under,/obj/spawner/cloth/suit,/turf/simulated/floor/carpet/turcarpet,/area/template_noop)
"e" = (/turf/simulated/floor/carpet/turcarpet,/area/template_noop)
"f" = (/obj/structure/bed,/obj/item/weapon/bedsheet,/turf/simulated/floor/carpet/turcarpet,/area/template_noop)
"g" = (/obj/effect/window_lwall_spawn,/turf/simulated/floor/wood,/area/template_noop)
"h" = (/obj/structure/table/woodentable,/obj/item/weapon/board,/turf/simulated/floor/wood,/area/template_noop)
"i" = (/obj/structure/table/woodentable,/obj/spawner/contraband,/obj/spawner/gun/shotgun,/turf/simulated/floor/carpet/turcarpet,/area/template_noop)
"j" = (/obj/structure/table/woodentable,/obj/item/clothing/mask/smokable/pipe/cobpipe,/turf/simulated/floor/carpet/turcarpet,/area/template_noop)
"k" = (/obj/structure/table/woodentable,/obj/item/weapon/material/kitchen/utensil/fork/plastic,/obj/item/weapon/material/kitchen/utensil/fork/plastic,/obj/item/weapon/material/kitchen/utensil/fork/plastic,/obj/effect/floor_decal/spline/fancy/wood/corner{dir = 1},/turf/simulated/floor/carpet/turcarpet,/area/template_noop)
"l" = (/obj/structure/table/woodentable,/obj/effect/floor_decal/spline/fancy/wood{icon_state = "spline_fancy"; dir = 1},/turf/simulated/floor/carpet/turcarpet,/area/template_noop)
"m" = (/obj/structure/closet/crate/freezer,/obj/effect/floor_decal/spline/fancy/wood{icon_state = "spline_fancy"; dir = 1},/obj/spawner/booze,/obj/spawner/junkfood,/obj/spawner/junkfood,/obj/spawner/junkfood,/turf/simulated/floor/carpet/turcarpet,/area/template_noop)
"n" = (/obj/effect/floor_decal/spline/fancy/wood{dir = 4},/obj/effect/floor_decal/spline/fancy/wood/corner{dir = 4},/turf/simulated/floor/carpet/turcarpet,/area/template_noop)
"o" = (/turf/simulated/floor/wood,/area/template_noop)
"p" = (/obj/structure/bed/chair/wood{tag = "icon-wooden_chair_preview (WEST)"; icon_state = "wooden_chair_preview"; dir = 8},/obj/effect/floor_decal/spline/fancy/wood/corner,/turf/simulated/floor/wood,/area/template_noop)
"q" = (/obj/structure/table/woodentable,/obj/item/weapon/deck/cards,/turf/simulated/floor/wood,/area/template_noop)
"r" = (/obj/effect/floor_decal/spline/fancy/wood{icon_state = "spline_fancy"; dir = 1},/turf/simulated/floor/wood,/area/template_noop)
"s" = (/obj/structure/table/woodentable,/obj/effect/decal/cleanable/blood/drip,/obj/effect/decal/cleanable/blood/drip,/obj/effect/decal/cleanable/blood/drip,/obj/spawner/pack/rare,/turf/simulated/floor/carpet/turcarpet,/area/template_noop)
"t" = (/obj/effect/floor_decal/spline/fancy/wood{dir = 4},/turf/simulated/floor/carpet/turcarpet,/area/template_noop)
"u" = (/obj/machinery/r_n_d/server/robotics{desc = "A jury-rigged server setup."; name = "low-tech server"},/turf/simulated/floor/carpet/turcarpet,/area/template_noop)
"v" = (/obj/structure/table/woodentable,/obj/effect/floor_decal/spline/fancy/wood,/obj/spawner/firstaid,/turf/simulated/floor/carpet/turcarpet,/area/template_noop)
"w" = (/turf/simulated/floor/wood/usedup,/area/template_noop)
"x" = (/obj/effect/floor_decal/spline/fancy/wood,/turf/simulated/floor/carpet/turcarpet,/area/template_noop)
"y" = (/obj/effect/floor_decal/spline/fancy/wood{dir = 6},/turf/simulated/floor/carpet/turcarpet,/area/template_noop)
"z" = (/obj/structure/table/woodentable,/obj/machinery/computer/atmoscontrol/laptop{desc = "A cheap, beat-up old laptop."; name = "old laptop"},/obj/spawner/lathe_disk,/obj/spawner/lathe_disk,/turf/simulated/floor/carpet/turcarpet,/area/template_noop)
"A" = (/obj/effect/floor_decal/spline/fancy/wood{dir = 4},/turf/simulated/floor/wood,/area/template_noop)
"B" = (/obj/effect/floor_decal/spline/fancy/wood/corner{dir = 1},/turf/simulated/floor/wood,/area/template_noop)
"C" = (/obj/structure/bed/chair/wood{tag = "icon-wooden_chair_preview (WEST)"; icon_state = "wooden_chair_preview"; dir = 8},/obj/effect/floor_decal/spline/fancy/wood{dir = 4},/turf/simulated/floor/carpet/turcarpet,/area/template_noop)
"D" = (/obj/spawner/lowkeyrandom,/obj/spawner/lowkeyrandom,/turf/simulated/floor/wood/usedup,/area/template_noop)
"E" = (/obj/effect/floor_decal/spline/fancy/wood/corner,/turf/simulated/floor/wood,/area/template_noop)
"F" = (/obj/effect/floor_decal/spline/fancy/wood,/turf/simulated/floor/wood,/area/template_noop)
"G" = (/obj/effect/floor_decal/spline/fancy/wood/corner{dir = 8},/turf/simulated/floor/wood,/area/template_noop)
"H" = (/obj/machinery/door/unpowered/simple/wood,/turf/simulated/floor/wood,/area/template_noop)
"I" = (/obj/structure/table/rack,/obj/spawner/credits,/turf/simulated/floor/wood,/area/template_noop)
"J" = (/obj/structure/closet,/obj/effect/floor_decal/spline/fancy/wood/corner{dir = 8},/obj/spawner/ammo/shotgun,/turf/simulated/floor/wood,/area/template_noop)
"L" = (/obj/machinery/portable_atmospherics/hydroponics/soil,/obj/item/seeds/towermycelium,/turf/template_noop,/area/template_noop)
"M" = (/obj/machinery/portable_atmospherics/hydroponics/soil,/obj/item/seeds/potatoseed,/turf/template_noop,/area/template_noop)
"O" = (/obj/machinery/portable_atmospherics/hydroponics/soil,/obj/item/seeds/wheatseed,/turf/template_noop,/area/template_noop)
"P" = (/obj/machinery/portable_atmospherics/hydroponics/soil,/obj/item/seeds/random,/turf/template_noop,/area/template_noop)
"Q" = (/obj/machinery/portable_atmospherics/powered/scrubber,/turf/simulated/floor/wood,/area/template_noop)
"S" = (/obj/machinery/portable_atmospherics/powered/scrubber,/obj/effect/floor_decal/spline/fancy/wood/corner,/turf/simulated/floor/wood,/area/template_noop)

(1,1,1) = {"
aabbbbbbaaaaaaaa
aabdeefbbggbbbbb
aabieejbklmnoocb
bbbrrrrbseetooob
butwooobvxxyohpb
bzCEFFGHEFGwoqAg
bbbbggbbbgbbooAg
aaaaLaLaMaMbDoBb
aaaaLaMaOaPbQoIb
aaaaaaaaaaabSFJb
aaaaaaaaaaabbHbb
"}
