"aa" = (/obj/structure/grille,/turf/simulated/floor/plating,/area/map_template/crashed_pod)
"ab" = (/turf/simulated/wall/r_wall,/area/map_template/crashed_pod)
"ac" = (/obj/machinery/atmospherics/unary/engine,/turf/simulated/floor/plating,/area/map_template/crashed_pod)
"ad" = (/obj/structure/shuttle/engine/heater{icon_state = "heater"; dir = 1},/obj/structure/grille,/obj/effect/submap_landmark/joinable_submap/crashed_pod,/turf/simulated/floor/plating,/area/map_template/crashed_pod)
"ae" = (/obj/structure/shuttle/engine/heater{icon_state = "heater"; dir = 1},/obj/structure/grille,/turf/simulated/floor/plating,/area/map_template/crashed_pod)
"af" = (/obj/machinery/atmospherics/pipe/simple/visible/red{icon_state = "intact"; dir = 6},/turf/simulated/wall/r_wall,/area/map_template/crashed_pod)
"ag" = (/obj/structure/shuttle/engine/heater{icon_state = "heater"; dir = 1},/obj/structure/grille,/obj/machinery/atmospherics/pipe/simple/visible/red{dir = 10},/turf/simulated/floor/plating,/area/map_template/crashed_pod)
"ah" = (/obj/machinery/alarm{dir = 4; locked = 0; pixel_x = -25; pixel_y = 0},/obj/machinery/atmospherics/unary/vent_pump/on,/obj/effect/decal/cleanable/dirt,/turf/simulated/floor/tiled/techmaint_panels,/area/map_template/crashed_pod)
"ai" = (/obj/effect/decal/cleanable/dirt,/obj/item/trash/raisins,/turf/simulated/floor/tiled/techmaint_panels,/area/map_template/crashed_pod)
"aj" = (/obj/effect/decal/cleanable/dirt,/obj/effect/decal/cleanable/dirt,/turf/simulated/floor/tiled/techmaint_panels,/area/map_template/crashed_pod)
"ak" = (/obj/machinery/power/terminal,/obj/machinery/light/small{dir = 1},/obj/structure/cable{icon_state = "0-4"; d2 = 4},/obj/effect/decal/cleanable/dirt,/obj/effect/decal/cleanable/dirt,/turf/simulated/floor/tiled/techmaint_panels,/area/map_template/crashed_pod)
"al" = (/obj/structure/sign/kiddieplaque{desc = "A plaque with information regarding this particular lifepod. It reads: 'Armalev Industries Skyfin-E, Exoplanetary Suvival Pod' there's a registry number, and an assigned mothership, but they've both been scratched to illegiblity."; name = "\improper Lifepod Plaque"; pixel_y = 30},/obj/structure/cable{d1 = 2; d2 = 8; icon_state = "2-8"},/obj/effect/decal/cleanable/dirt,/turf/simulated/floor/tiled/techmaint_panels,/area/map_template/crashed_pod)
"am" = (/obj/machinery/atmospherics/pipe/simple/visible/cyan{icon_state = "intact"; dir = 6},/obj/effect/decal/cleanable/dirt,/obj/effect/decal/cleanable/dirt,/turf/simulated/floor/tiled/techmaint_panels,/area/map_template/crashed_pod)
"an" = (/obj/machinery/atmospherics/omni/filter,/obj/effect/decal/cleanable/dirt,/turf/simulated/floor/tiled/techmaint_panels,/area/map_template/crashed_pod)
"ao" = (/obj/machinery/atmospherics/pipe/manifold/visible/red{icon_state = "map"; dir = 4},/obj/effect/decal/cleanable/dirt,/obj/item/trash/tastybread,/turf/simulated/floor/tiled/techmaint_panels,/area/map_template/crashed_pod)
"ap" = (/obj/effect/decal/cleanable/dirt,/obj/effect/decal/cleanable/dirt,/obj/effect/decal/cleanable/vomit,/obj/structure/curtain/open/shower/engineering,/obj/structure/mirror{dir = 8; pixel_x = 28},/turf/simulated/floor/tiled/techmaint_panels,/area/map_template/crashed_pod)
"aq" = (/obj/machinery/atmospherics/pipe/simple/hidden/supply,/obj/machinery/atmospherics/unary/vent_scrubber/on,/obj/effect/decal/cleanable/dirt,/turf/simulated/floor/tiled/techmaint_panels,/area/map_template/crashed_pod)
"ar" = (/obj/effect/floor_decal/industrial/outline/blue,/obj/machinery/power/apc{dir = 2; locked = 0; name = "south bump"; operating = 1; pixel_y = -28},/obj/structure/cable{icon_state = "0-4"; d2 = 4},/obj/effect/decal/cleanable/dirt,/obj/machinery/portable_atmospherics/canister/carbon_dioxide,/turf/simulated/floor/tiled/techmaint_cargo,/area/map_template/crashed_pod)
"as" = (/obj/effect/floor_decal/industrial/outline/blue,/obj/structure/cable{d1 = 4; d2 = 8; icon_state = "4-8"},/obj/machinery/space_heater,/obj/effect/decal/cleanable/dirt,/turf/simulated/floor/tiled/techmaint_cargo,/area/map_template/crashed_pod)
"at" = (/obj/structure/cable{d2 = 8; icon_state = "0-8"},/obj/effect/decal/cleanable/dirt,/obj/machinery/power/smes/buildable{charge = 50000; inputting = 1; outputting = 1},/turf/simulated/floor/tiled/techmaint_cargo,/area/map_template/crashed_pod)
"au" = (/obj/structure/closet/crate,/obj/item/device/scanner/gas,/obj/item/weapon/tank/oxygen/red,/obj/structure/cable,/obj/effect/decal/cleanable/dirt,/obj/item/trash/liquidfood,/obj/item/weapon/stock_parts/matter_bin/super,/obj/item/weapon/bedsheet/orange,/obj/item/weapon/bedsheet/orange,/obj/item/weapon/stock_parts/matter_bin/adv,/obj/item/weapon/stock_parts/micro_laser/ultra,/obj/item/weapon/reagent_containers/food/snacks/liquidfood,/obj/item/stack/material/sandstone{amount = 50},/obj/item/stack/material/uranium/random,/obj/item/stack/material/uranium/random,/obj/item/stack/material/plasteel/random,/obj/item/stack/material/plasteel/random,/turf/simulated/floor/tiled/techmaint_cargo,/area/map_template/crashed_pod)
"av" = (/obj/machinery/atmospherics/pipe/manifold/visible/cyan{icon_state = "map"; dir = 8},/obj/structure/reagent_dispensers/fueltank,/obj/effect/decal/cleanable/dirt,/turf/simulated/floor/tiled/techmaint_cargo,/area/map_template/crashed_pod)
"aw" = (/obj/machinery/atmospherics/omni/filter,/obj/effect/decal/cleanable/dirt,/turf/simulated/floor/tiled/techmaint_cargo,/area/map_template/crashed_pod)
"ax" = (/obj/machinery/atmospherics/pipe/manifold/visible/red{icon_state = "map"; dir = 4},/obj/effect/decal/cleanable/dirt,/turf/simulated/floor/tiled/techmaint_panels,/area/map_template/crashed_pod)
"ay" = (/turf/simulated/wall,/area/map_template/crashed_pod)
"az" = (/obj/machinery/atmospherics/binary/pump,/turf/simulated/wall,/area/map_template/crashed_pod)
"aA" = (/obj/effect/decal/cleanable/dirt,/obj/effect/decal/cleanable/dirt,/obj/structure/curtain/open/shower/engineering,/obj/structure/toilet{dir = 8},/turf/simulated/floor/tiled/techmaint_panels,/area/map_template/crashed_pod)
"aB" = (/obj/machinery/door/firedoor,/obj/machinery/door/airlock/engineering,/obj/machinery/atmospherics/pipe/simple/hidden/supply,/obj/machinery/atmospherics/pipe/simple/hidden/scrubbers,/obj/effect/decal/cleanable/dirt,/turf/simulated/floor/tiled/techmaint_panels,/area/map_template/crashed_pod)
"aC" = (/obj/effect/window_lwall_spawn,/turf/simulated/floor/plating,/area/map_template/crashed_pod)
"aD" = (/obj/machinery/atmospherics/pipe/simple/visible/red{icon_state = "intact"; dir = 5},/turf/simulated/wall,/area/map_template/crashed_pod)
"aE" = (/obj/machinery/door/firedoor,/obj/machinery/door/airlock/engineering,/obj/machinery/atmospherics/pipe/manifold/visible/red{icon_state = "map"; dir = 4},/obj/effect/decal/cleanable/dirt,/turf/simulated/floor/tiled/techmaint_panels,/area/map_template/crashed_pod)
"aF" = (/obj/machinery/sleeper{dir = 4},/obj/effect/floor_decal/industrial/outline/blue,/obj/effect/decal/cleanable/cobweb,/turf/simulated/floor/tiled/techmaint,/area/map_template/crashed_pod)
"aG" = (/obj/effect/floor_decal/industrial/warning{dir = 8},/obj/machinery/atmospherics/pipe/manifold/hidden/scrubbers{dir = 8},/obj/machinery/atmospherics/pipe/manifold/hidden/supply{dir = 8},/obj/effect/decal/cleanable/dirt,/turf/simulated/floor/tiled/techmaint,/area/map_template/crashed_pod)
"aH" = (/obj/machinery/atmospherics/pipe/simple/hidden/supply{dir = 4},/obj/machinery/atmospherics/unary/vent_scrubber/on{dir = 8},/obj/machinery/light/small{dir = 1},/obj/item/weapon/mop,/obj/effect/decal/cleanable/dirt,/obj/item/trash/liquidfood,/turf/simulated/floor/tiled/techmaint,/area/map_template/crashed_pod)
"aI" = (/obj/machinery/atmospherics/unary/vent_pump/on{dir = 8},/obj/machinery/portable_atmospherics/canister/oxygen,/obj/effect/decal/cleanable/dirt,/turf/simulated/floor/tiled/techmaint,/area/map_template/crashed_pod)
"aJ" = (/obj/effect/floor_decal/industrial/outline/blue,/obj/effect/decal/cleanable/generic,/turf/simulated/floor/tiled/techmaint,/area/map_template/crashed_pod)
"aK" = (/obj/machinery/atmospherics/pipe/simple/hidden/cyan,/obj/effect/decal/cleanable/dirt,/obj/item/solar_assembly,/obj/item/solar_assembly,/obj/item/solar_assembly,/obj/item/solar_assembly,/turf/simulated/floor/tiled/techmaint,/area/map_template/crashed_pod)
"aL" = (/obj/machinery/atmospherics/pipe/simple/visible/red{icon_state = "intact"; dir = 6},/obj/machinery/light/small{dir = 1},/obj/effect/decal/cleanable/dirt,/obj/effect/decal/cleanable/dirt,/turf/simulated/floor/tiled/techmaint,/area/map_template/crashed_pod)
"aM" = (/obj/effect/floor_decal/industrial/warning{dir = 4},/obj/machinery/atmospherics/pipe/manifold/visible/red{icon_state = "map"; dir = 4},/obj/effect/decal/cleanable/dirt,/turf/simulated/floor/tiled/techmaint,/area/map_template/crashed_pod)
"aN" = (/obj/machinery/pipedispenser,/obj/effect/floor_decal/industrial/outline/blue,/obj/effect/decal/cleanable/generic,/obj/effect/decal/cleanable/cobweb2,/turf/simulated/floor/tiled/techmaint,/area/map_template/crashed_pod)
"aO" = (/obj/machinery/sleeper{dir = 4},/obj/effect/floor_decal/industrial/outline/blue,/turf/simulated/floor/tiled/techmaint,/area/map_template/crashed_pod)
"aP" = (/obj/effect/floor_decal/industrial/warning{dir = 8},/obj/machinery/atmospherics/pipe/simple/hidden/scrubbers,/obj/machinery/atmospherics/pipe/manifold/hidden/supply{dir = 8},/obj/effect/decal/cleanable/dirt,/turf/simulated/floor/tiled/techmaint,/area/map_template/crashed_pod)
"aQ" = (/obj/machinery/atmospherics/pipe/simple/hidden/universal{icon_state = "map_universal"; dir = 4},/obj/effect/decal/cleanable/dirt,/turf/simulated/floor/tiled/techmaint,/area/map_template/crashed_pod)
"aR" = (/obj/machinery/atmospherics/binary/pump{dir = 8},/obj/effect/decal/cleanable/dirt,/obj/effect/decal/cleanable/dirt,/turf/simulated/floor/tiled/techmaint,/area/map_template/crashed_pod)
"aS" = (/obj/machinery/atmospherics/pipe/manifold/hidden,/obj/effect/decal/cleanable/dirt,/obj/effect/decal/cleanable/dirt,/turf/simulated/floor/tiled/techmaint,/area/map_template/crashed_pod)
"aT" = (/obj/machinery/atmospherics/pipe/manifold/hidden,/obj/effect/decal/cleanable/dirt,/turf/simulated/floor/tiled/techmaint,/area/map_template/crashed_pod)
"aU" = (/obj/machinery/atmospherics/pipe/simple/hidden/cyan{dir = 9; icon_state = "intact"},/obj/effect/decal/cleanable/dirt,/obj/item/trash/tastybread,/turf/simulated/floor/tiled/techmaint,/area/map_template/crashed_pod)
"aV" = (/obj/machinery/atmospherics/portables_connector{dir = 1},/obj/machinery/portable_atmospherics/canister/empty,/obj/effect/decal/cleanable/dirt,/turf/simulated/floor/tiled/techmaint,/area/map_template/crashed_pod)
"aW" = (/obj/effect/floor_decal/industrial/warning{dir = 4},/obj/machinery/atmospherics/pipe/simple/visible/red,/obj/effect/decal/cleanable/dirt,/turf/simulated/floor/tiled/techmaint,/area/map_template/crashed_pod)
"aX" = (/obj/effect/floor_decal/industrial/outline/blue,/turf/simulated/floor/tiled/techmaint,/area/map_template/crashed_pod)
"aY" = (/obj/machinery/door/firedoor,/obj/machinery/atmospherics/pipe/simple/hidden/scrubbers,/obj/machinery/atmospherics/pipe/simple/hidden/supply,/obj/machinery/door/airlock,/turf/simulated/floor/tiled/techmaint,/area/map_template/crashed_pod)
"aZ" = (/obj/machinery/door/firedoor,/obj/machinery/atmospherics/pipe/simple/hidden/universal,/obj/effect/decal/cleanable/dirt,/obj/machinery/door/airlock,/turf/simulated/floor/tiled/techmaint,/area/map_template/crashed_pod)
"ba" = (/obj/machinery/atmospherics/pipe/simple/hidden/supply,/obj/machinery/atmospherics/pipe/simple/hidden/scrubbers,/obj/effect/decal/cleanable/dirt,/obj/effect/decal/cleanable/dirt,/turf/simulated/floor/tiled/techmaint_perforated,/area/map_template/crashed_pod)
"bb" = (/obj/structure/window/reinforced{dir = 8},/obj/machinery/atmospherics/pipe/simple/hidden/scrubbers,/obj/machinery/light{dir = 1},/obj/effect/decal/cleanable/dirt,/turf/simulated/floor/tiled/techmaint_panels,/area/map_template/crashed_pod)
"bc" = (/obj/effect/decal/cleanable/dirt,/turf/simulated/floor/tiled/techmaint_panels,/area/map_template/crashed_pod)
"bd" = (/obj/structure/table/steel_reinforced,/obj/item/device/radio,/obj/item/device/radio,/obj/item/device/radio,/obj/item/device/radio,/obj/item/device/radio,/obj/spawner/toy/plushie,/obj/effect/decal/cleanable/dirt,/turf/simulated/floor/tiled/techmaint_panels,/area/map_template/crashed_pod)
"be" = (/obj/machinery/light/small{dir = 1},/obj/structure/bed/chair,/obj/effect/decal/cleanable/dirt,/turf/simulated/floor/tiled/dark,/area/map_template/crashed_pod)
"bf" = (/obj/structure/table/steel_reinforced,/obj/machinery/recharger,/obj/effect/decal/cleanable/dirt,/turf/simulated/floor/tiled/techmaint_panels,/area/map_template/crashed_pod)
"bg" = (/obj/structure/window/reinforced{dir = 4},/obj/machinery/light{dir = 1},/obj/effect/decal/cleanable/dirt,/turf/simulated/floor/tiled/techmaint_panels,/area/map_template/crashed_pod)
"bh" = (/obj/structure/window/reinforced{dir = 8},/obj/effect/floor_decal/industrial/warning,/obj/effect/decal/cleanable/dirt,/turf/simulated/floor/tiled/dark,/area/map_template/crashed_pod)
"bi" = (/obj/effect/floor_decal/industrial/warning,/obj/effect/decal/cleanable/dirt,/turf/simulated/floor/tiled/dark,/area/map_template/crashed_pod)
"bj" = (/obj/machinery/atmospherics/pipe/simple/hidden/scrubbers,/turf/simulated/floor/tiled/techmaint_perforated,/area/map_template/crashed_pod)
"bk" = (/obj/machinery/atmospherics/unary/vent_pump/on,/obj/effect/floor_decal/industrial/warning,/obj/effect/decal/cleanable/dirt,/obj/effect/decal/cleanable/dirt,/turf/simulated/floor/tiled/dark,/area/map_template/crashed_pod)
"bl" = (/obj/machinery/atmospherics/unary/vent_scrubber/on,/obj/effect/floor_decal/industrial/warning,/obj/effect/decal/cleanable/dirt,/turf/simulated/floor/tiled/dark,/area/map_template/crashed_pod)
"bm" = (/obj/effect/floor_decal/industrial/warning,/obj/effect/decal/cleanable/dirt,/obj/item/trash/liquidfood,/turf/simulated/floor/tiled/dark,/area/map_template/crashed_pod)
"bn" = (/obj/structure/window/reinforced{dir = 4},/obj/effect/floor_decal/industrial/warning,/obj/effect/decal/cleanable/dirt,/turf/simulated/floor/tiled/dark,/area/map_template/crashed_pod)
"bo" = (/obj/effect/window_lwall_spawn/reinforced,/turf/simulated/floor/tiled/techmaint,/area/map_template/crashed_pod)
"bp" = (/obj/machinery/atmospherics/pipe/simple/hidden/scrubbers,/obj/effect/decal/cleanable/dirt,/turf/simulated/floor/tiled/techmaint_perforated,/area/map_template/crashed_pod)
"bq" = (/obj/structure/closet/emcloset,/obj/machinery/light/small{dir = 1},/turf/simulated/floor/tiled/dark,/area/map_template/crashed_pod)
"br" = (/obj/structure/table/steel_reinforced,/obj/machinery/microwave,/turf/simulated/floor/tiled/dark,/area/map_template/crashed_pod)
"bs" = (/obj/structure/table/steel_reinforced,/obj/effect/decal/cleanable/flour,/obj/machinery/reagentgrinder,/obj/spawner/booze,/obj/spawner/booze,/obj/spawner/booze,/obj/spawner/rations,/obj/spawner/rations,/turf/simulated/floor/tiled/techmaint,/area/map_template/crashed_pod)
"bt" = (/obj/machinery/atmospherics/pipe/simple/hidden/supply{dir = 5},/obj/machinery/atmospherics/pipe/simple/hidden/scrubbers{dir = 5},/obj/effect/decal/cleanable/dirt,/obj/effect/decal/cleanable/dirt,/obj/effect/decal/cleanable/dirt,/turf/simulated/floor/tiled/techmaint_perforated,/area/map_template/crashed_pod)
"bu" = (/obj/machinery/atmospherics/pipe/simple/hidden/supply{dir = 4},/obj/machinery/atmospherics/pipe/simple/hidden/scrubbers{dir = 4},/obj/effect/decal/cleanable/dirt,/obj/effect/decal/cleanable/dirt,/turf/simulated/floor/tiled/techmaint_perforated,/area/map_template/crashed_pod)
"bv" = (/obj/machinery/atmospherics/pipe/simple/hidden/supply{dir = 4},/obj/machinery/atmospherics/pipe/simple/hidden/scrubbers{dir = 4},/obj/effect/decal/cleanable/dirt,/turf/simulated/floor/tiled/techmaint_perforated,/area/map_template/crashed_pod)
"bw" = (/obj/machinery/atmospherics/pipe/manifold/hidden/supply{dir = 4},/obj/machinery/atmospherics/pipe/manifold/hidden/scrubbers{dir = 1},/obj/effect/decal/cleanable/dirt,/turf/simulated/floor/tiled/techmaint_perforated,/area/map_template/crashed_pod)
"bx" = (/obj/machinery/alarm{dir = 4; locked = 0; pixel_x = -25; pixel_y = 0},/obj/structure/bed/chair{dir = 1},/obj/effect/decal/cleanable/dirt,/turf/simulated/floor/tiled/dark,/area/map_template/crashed_pod)
"by" = (/obj/machinery/atmospherics/pipe/manifold/hidden/scrubbers,/obj/effect/decal/cleanable/dirt,/turf/simulated/floor/tiled/techmaint_perforated,/area/map_template/crashed_pod)
"bz" = (/obj/machinery/atmospherics/pipe/simple/hidden/scrubbers{dir = 4},/obj/effect/decal/cleanable/dirt,/turf/simulated/floor/tiled/techmaint_perforated,/area/map_template/crashed_pod)
"bA" = (/obj/machinery/atmospherics/pipe/simple/hidden/scrubbers{dir = 9},/obj/effect/decal/cleanable/dirt,/turf/simulated/floor/tiled/techmaint_perforated,/area/map_template/crashed_pod)
"bB" = (/obj/effect/floor_decal/industrial/warning,/obj/effect/decal/cleanable/dirt,/obj/effect/decal/cleanable/dirt,/turf/simulated/floor/tiled/techmaint_perforated,/area/map_template/crashed_pod)
"bC" = (/obj/effect/floor_decal/industrial/warning,/obj/structure/table/steel_reinforced,/obj/item/device/binoculars,/obj/effect/decal/cleanable/dirt,/obj/effect/decal/cleanable/dirt,/turf/simulated/floor/tiled/techmaint_panels,/area/map_template/crashed_pod)
"bD" = (/obj/structure/table/steel_reinforced,/obj/effect/decal/cleanable/dirt,/obj/item/trash/tastybread,/obj/effect/decal/cleanable/dirt,/turf/simulated/floor/tiled/techmaint_panels,/area/map_template/crashed_pod)
"bE" = (/obj/machinery/atmospherics/pipe/manifold/hidden/supply{dir = 8},/obj/machinery/atmospherics/pipe/manifold/hidden/scrubbers{dir = 8},/turf/simulated/floor/tiled/techmaint_perforated,/area/map_template/crashed_pod)
"bF" = (/obj/machinery/atmospherics/pipe/simple/hidden/supply{dir = 4},/obj/machinery/atmospherics/pipe/simple/hidden/scrubbers{dir = 4},/obj/structure/closet,/obj/item/clothing,/obj/item/clothing,/obj/item/clothing,/obj/item/clothing,/obj/item/clothing,/obj/item/clothing,/obj/item/clothing,/obj/item/clothing,/obj/item/clothing,/obj/item/weapon/storage/box/gloves,/obj/item/weapon/storage/box/gloves,/obj/item/clothing/under/color/orange,/obj/item/clothing/under/color/orange,/obj/item/clothing/under/color/black,/obj/effect/decal/cleanable/dirt,/turf/simulated/floor/tiled/techmaint_panels,/area/map_template/crashed_pod)
"bG" = (/obj/machinery/atmospherics/pipe/simple/hidden/supply{dir = 4},/obj/machinery/atmospherics/pipe/simple/hidden/scrubbers{dir = 4},/obj/structure/closet,/obj/item/clothing,/obj/item/clothing,/obj/item/clothing,/obj/item/clothing,/obj/item/clothing,/obj/item/clothing,/obj/item/clothing,/obj/item/clothing,/obj/item/weapon/storage/box/gloves,/obj/item/weapon/storage/box/gloves,/obj/item/clothing/under/color/orange,/obj/item/clothing/under/color/orange,/obj/item/clothing/under/color/black,/obj/effect/decal/cleanable/dirt,/turf/simulated/floor/tiled/techmaint_panels,/area/map_template/crashed_pod)
"bH" = (/obj/machinery/atmospherics/pipe/simple/hidden/supply{dir = 4},/obj/machinery/atmospherics/pipe/simple/hidden/scrubbers{dir = 4},/obj/structure/closet,/obj/item/clothing,/obj/item/clothing,/obj/item/clothing,/obj/item/clothing,/obj/item/clothing,/obj/item/clothing,/obj/item/clothing,/obj/item/clothing,/obj/item/weapon/storage/box/gloves,/obj/item/clothing/under/color/orange,/obj/item/clothing/under/color/orange,/obj/item/clothing/under/color/black,/obj/effect/decal/cleanable/dirt,/turf/simulated/floor/tiled/techmaint_panels,/area/map_template/crashed_pod)
"bI" = (/obj/machinery/atmospherics/pipe/simple/hidden/supply{dir = 10},/obj/machinery/atmospherics/pipe/simple/hidden/scrubbers{dir = 10},/turf/simulated/floor/tiled/techmaint_perforated,/area/map_template/crashed_pod)
"bJ" = (/obj/machinery/door/airlock/external{name = "escape pod airlock"},/turf/simulated/floor/tiled/techmaint_perforated,/area/map_template/crashed_pod)
"bK" = (/obj/effect/floor_decal/industrial/warning,/obj/machinery/light/small,/obj/effect/decal/cleanable/ash,/obj/item/trash/cigbutt/cigarbutt,/obj/effect/decal/cleanable/dirt,/turf/simulated/floor/tiled/dark,/area/map_template/crashed_pod)
"bL" = (/obj/machinery/door/firedoor,/obj/machinery/atmospherics/pipe/simple/hidden/supply,/obj/machinery/atmospherics/pipe/simple/hidden/scrubbers,/obj/machinery/door/airlock/engineering,/turf/simulated/floor/tiled/techmaint_perforated,/area/map_template/crashed_pod)
"bM" = (/obj/structure/table/rack,/obj/item/clothing/suit/space/emergency,/obj/item/clothing/suit/space/emergency,/obj/machinery/light/small{dir = 8},/turf/simulated/floor/tiled/techmaint_perforated,/area/map_template/crashed_pod)
"bN" = (/turf/simulated/floor/tiled/techmaint_panels,/area/map_template/crashed_pod)
"bO" = (/obj/structure/closet/crate/freezer/rations,/obj/item/weapon/storage/bag/trash,/obj/item/weapon/storage/bag/trash,/obj/item/weapon/storage/box/donkpockets,/obj/item/weapon/storage/box/donkpockets,/obj/item/weapon/storage/fancy/egg_box,/obj/item/weapon/storage/fancy/egg_box,/obj/item/weapon/storage/fancy/egg_box,/obj/item/weapon/reagent_containers/food/condiment/enzyme,/obj/item/weapon/reagent_containers/food/drinks/milk,/obj/item/weapon/reagent_containers/food/drinks/milk,/obj/item/trash/liquidfood,/obj/item/trash/liquidfood,/obj/item/trash/liquidfood,/obj/item/trash/liquidfood,/obj/item/weapon/beartrap,/obj/item/weapon/reagent_containers/food/snacks/liquidfood,/obj/item/weapon/reagent_containers/food/snacks/liquidfood,/obj/item/weapon/reagent_containers/food/snacks/liquidfood,/obj/item/weapon/reagent_containers/food/snacks/liquidfood,/obj/item/weapon/reagent_containers/food/snacks/liquidfood,/obj/item/weapon/reagent_containers/food/snacks/liquidfood,/obj/item/weapon/reagent_containers/food/snacks/liquidfood,/obj/item/weapon/reagent_containers/food/snacks/liquidfood,/turf/simulated/floor/tiled/techmaint_panels,/area/map_template/crashed_pod)
"bP" = (/obj/machinery/atmospherics/pipe/simple/hidden/supply,/obj/machinery/atmospherics/unary/vent_scrubber/on{dir = 1},/turf/simulated/floor/tiled/techmaint_panels,/area/map_template/crashed_pod)
"bQ" = (/obj/structure/closet/crate/medical,/obj/spawner/firstaid,/obj/spawner/firstaid,/obj/spawner/firstaid,/obj/spawner/firstaid,/obj/spawner/firstaid,/obj/item/weapon/storage/firstaid/surgery,/turf/simulated/floor/tiled/techmaint_panels,/area/map_template/crashed_pod)
"bR" = (/obj/structure/reagent_dispensers/watertank,/turf/simulated/floor/tiled/techmaint_panels,/area/map_template/crashed_pod)
"bS" = (/obj/structure/closet/crate,/obj/item/weapon/storage/briefcase/inflatable,/obj/item/weapon/storage/briefcase/inflatable,/obj/item/weapon/storage/briefcase/inflatable,/obj/item/weapon/storage/briefcase/inflatable,/obj/item/weapon/storage/briefcase/inflatable,/obj/machinery/atmospherics/pipe/simple/hidden/supply,/obj/machinery/atmospherics/unary/vent_scrubber/on{dir = 1},/turf/simulated/floor/tiled/techmaint_panels,/area/map_template/crashed_pod)
"bT" = (/obj/structure/closet/emcloset,/obj/machinery/light/small,/turf/simulated/floor/tiled/dark,/area/map_template/crashed_pod)
"bU" = (/obj/machinery/portable_atmospherics/hydroponics,/turf/simulated/floor/tiled/techmaint_panels,/area/map_template/crashed_pod)
"bV" = (/obj/structure/table/rack,/obj/item/clothing/suit/space/emergency,/obj/item/clothing/suit/space/emergency,/turf/simulated/floor/tiled/techmaint_perforated,/area/map_template/crashed_pod)
"bW" = (/obj/structure/closet/crate,/turf/simulated/floor/tiled/techmaint_panels,/area/map_template/crashed_pod)
"bX" = (/obj/machinery/atmospherics/unary/vent_pump/on{dir = 1},/obj/machinery/power/port_gen/pacman/super,/obj/machinery/light/small,/turf/simulated/floor/tiled/techmaint_panels,/area/map_template/crashed_pod)
"bY" = (/obj/structure/table/steel_reinforced,/obj/item/weapon/storage/box/lights,/obj/item/device/scanner/gas,/obj/item/weapon/storage/box/monkeycubes,/obj/item/weapon/reagent_containers/food/drinks/bottle/vodka,/obj/item/weapon/tracker_electronics,/obj/item/weapon/pen/blue,/obj/item/weapon/pen/red,/turf/simulated/floor/tiled/techmaint_panels,/area/map_template/crashed_pod)
"bZ" = (/obj/machinery/seed_extractor,/turf/simulated/floor/tiled/techmaint_panels,/area/map_template/crashed_pod)
"ca" = (/obj/structure/table/steel_reinforced,/obj/item/weapon/paper_bin,/obj/effect/decal/cleanable/dirt,/obj/item/weapon/pen,/turf/simulated/floor/tiled/dark,/area/map_template/crashed_pod)
"cb" = (/obj/structure/closet/crate,/obj/machinery/atmospherics/unary/vent_pump/on{dir = 1},/obj/machinery/light/small,/turf/simulated/floor/tiled/techmaint_panels,/area/map_template/crashed_pod)
"cc" = (/obj/item/seeds/potatoseed,/obj/item/seeds/potatoseed,/obj/item/seeds/wheatseed,/obj/item/seeds/wheatseed,/obj/item/seeds/orangeseed,/obj/item/seeds/orangeseed,/obj/item/seeds/cornseed,/obj/item/seeds/cornseed,/obj/item/weapon/reagent_containers/glass/bucket,/obj/item/weapon/plantspray/pests,/obj/item/weapon/plantspray/pests,/obj/item/weapon/plantspray/weeds,/obj/item/seeds/poppyseed,/obj/item/seeds/towermycelium,/obj/item/seeds/glowshroom,/obj/item/seeds/whitebeetseed,/obj/item/seeds/bananaseed,/turf/simulated/floor/tiled/techmaint_panels,/area/map_template/crashed_pod)
"cd" = (/obj/effect/window_lwall_spawn/reinforced,/turf/simulated/floor/tiled/techmaint_perforated,/area/map_template/crashed_pod)

(1,1,1) = {"
aaabacabacababacabacabaa
aaabadabaeababaeafagabab
aaabahaiajakalamanaoapab
aaabaqarasatauavawaxaAab
ababaBayayaCaCazaDaEayab
abaFaGaHaIaJaJaKaLaMaNab
abaOaPaQaRaSaTaUaVaWaXab
abayaYayayaCaCayayaZayab
abbebabbbcbdbfbcbgbjbqab
bocababhbibkblbmbnbpbsbo
abbxbtbubvbwbybzbzbAbrab
abbKbBbCbDbEbFbGbHbIbTab
abaCbJabaybLayayaybLayab
abbMbNabbObPbQaybRbSbUab
abbVbNabbWbXbYaybZcbccab
ababbJababcdabababcdabab
"}
