//MAP CONVERTED BY dmm2tgm.py THIS HEADER COMMENT PREVENTS RECONVERSION, DO NOT REMOVE
"bf" = (
/turf/simulated/floor/tiled/white/bluecorner,
/area/deepmaint)
"bg" = (
/obj/structure/window/reinforced{
	dir = 4
	},
/obj/structure/bed/chair/custom/onestar/red,
/obj/machinery/atmospherics/unary/vent_scrubber/on,
/turf/simulated/floor/tiled/steel/techfloor,
/area/deepmaint)
"bJ" = (
/obj/structure/table/rack/shelf,
/obj/spawner/gun/energy_cheap,
/turf/simulated/floor/tiled/derelict/white_small_edges,
/area/deepmaint)
"bN" = (
/obj/item/modular_computer/console,
/turf/simulated/floor/tiled/steel,
/area/deepmaint)
"bQ" = (
/mob/living/carbon/superior_animal/stalker/dual,
/turf/simulated/floor/tiled/steel,
/area/deepmaint)
"cq" = (
/obj/machinery/atmospherics/unary/vent_scrubber/on,
/turf/simulated/floor/tiled/cafe,
/area/deepmaint)
"cE" = (
/obj/machinery/shower{
	dir = 1
	},
/obj/structure/curtain/open/shower,
/turf/simulated/floor/tiled/derelict/white_small_edges,
/area/deepmaint)
"cG" = (
/obj/structure/cyberplant,
/turf/simulated/floor/tiled/cafe,
/area/deepmaint)
"cM" = (
/obj/structure/railing{
	dir = 4;
	icon_state = "railing0";
	tag = "icon-railing0 (EAST)"
	},
/turf/simulated/floor/plating/under,
/area/deepmaint)
"da" = (
/obj/machinery/vending/snack,
/turf/simulated/floor/tiled/cafe,
/area/deepmaint)
"dl" = (
/turf/simulated/floor/tiled/dark/techfloor,
/area/deepmaint)
"dC" = (
/obj/machinery/vending/cart,
/obj/effect/decal/cleanable/dirt,
/turf/simulated/floor/carpet/bcarpet,
/area/deepmaint)
"dE" = (
/obj/structure/table/glass,
/turf/simulated/floor/tiled/cafe,
/area/deepmaint)
"dN" = (
/mob/living/simple_animal/hostile/onestar_custodian/chef,
/turf/simulated/floor/tiled/dark/gray_platform,
/area/deepmaint)
"eh" = (
/obj/structure/bed/alien,
/turf/simulated/floor/tiled/steel/brown_perforated,
/area/deepmaint)
"ev" = (
/obj/structure/table/standard{
	name = "plastic table frame"
	},
/obj/spawner/science/low_chance,
/turf/simulated/floor/tiled/steel,
/area/deepmaint)
"gB" = (
/obj/machinery/atmospherics/unary/vent_pump,
/obj/structure/table/glass,
/obj/spawner/tool/advanced/low_chance,
/turf/simulated/floor/carpet/bcarpet,
/area/deepmaint)
"gH" = (
/obj/machinery/light/small,
/turf/simulated/floor/plating/under,
/area/deepmaint)
"gX" = (
/obj/effect/decal/cleanable/dirt,
/turf/simulated/floor/tiled/derelict/white_small_edges,
/area/deepmaint)
"hl" = (
/obj/machinery/light,
/obj/structure/table/onestar,
/turf/simulated/floor/tiled/derelict/red_white_edges,
/area/deepmaint)
"hn" = (
/obj/spawner/tool/advanced/onestar,
/turf/simulated/floor/tiled/steel/techfloor,
/area/deepmaint)
"hQ" = (
/obj/structure/flora/ausbushes/brflowers,
/turf/simulated/floor/grass,
/area/deepmaint)
"jm" = (
/obj/machinery/light/small{
	dir = 4;
	pixel_y = 0
	},
/obj/structure/railing{
	dir = 1;
	icon_state = "railing0";
	tag = "icon-railing0 (NORTH)"
	},
/turf/simulated/floor/plating/under,
/area/deepmaint)
"kz" = (
/obj/structure/sink{
	dir = 8;
	pixel_x = -12
	},
/obj/structure/mirror{
	pixel_x = -28
	},
/turf/simulated/floor/tiled/derelict/white_small_edges,
/area/deepmaint)
"kK" = (
/mob/living/simple_animal/hostile/onestar_custodian,
/turf/simulated/floor/tiled/white,
/area/deepmaint)
"kS" = (
/obj/effect/window_lwall_spawn,
/obj/machinery/door/firedoor,
/turf/simulated/floor/plating,
/area/deepmaint)
"kY" = (
/obj/machinery/atmospherics/unary/vent_pump/on{
	dir = 1
	},
/turf/simulated/floor/tiled/steel,
/area/deepmaint)
"lm" = (
/obj/structure/flora/ausbushes/pointybush,
/turf/simulated/floor/grass,
/area/deepmaint)
"mb" = (
/obj/structure/flora/pottedplant{
	icon_state = "plant-21"
	},
/turf/simulated/floor/tiled/cafe,
/area/deepmaint)
"mK" = (
/mob/living/simple_animal/hostile/onestar_custodian,
/turf/simulated/floor/tiled/white/techfloor,
/area/deepmaint)
"nv" = (
/obj/machinery/door/airlock{
	name = "Unisex Restrooms"
	},
/turf/simulated/floor/tiled/white/panels,
/area/deepmaint)
"nG" = (
/obj/effect/decal/cleanable/dirt,
/turf/simulated/floor/tiled/steel,
/area/deepmaint)
"nK" = (
/obj/structure/toilet{
	dir = 4
	},
/obj/machinery/light{
	dir = 8
	},
/turf/simulated/floor/tiled/derelict/white_small_edges,
/area/deepmaint)
"om" = (
/obj/machinery/light,
/turf/simulated/floor/tiled/white,
/area/deepmaint)
"os" = (
/obj/machinery/vending/sovietsoda,
/turf/simulated/floor/tiled/white/cargo,
/area/deepmaint)
"oy" = (
/obj/machinery/atmospherics/unary/vent_scrubber/on,
/turf/simulated/floor/tiled/steel,
/area/deepmaint)
"oY" = (
/mob/living/simple_animal/hostile/roomba,
/turf/simulated/floor/tiled/white,
/area/deepmaint)
"pq" = (
/obj/structure/window/reinforced{
	dir = 4
	},
/mob/living/simple_animal/hostile/onestar_custodian,
/turf/simulated/floor/tiled/steel/techfloor,
/area/deepmaint)
"ps" = (
/obj/machinery/atmospherics/pipe/manifold/hidden/supply{
	dir = 4
	},
/obj/effect/window_lwall_spawn,
/turf/simulated/floor/plating,
/area/deepmaint)
"pH" = (
/turf/simulated/floor/tiled/cafe,
/area/deepmaint)
"qt" = (
/obj/structure/window/reinforced{
	dir = 8
	},
/obj/structure/flora/ausbushes/fernybush,
/turf/simulated/floor/grass,
/area/deepmaint)
"rm" = (
/turf/simulated/floor/tiled/steel,
/area/deepmaint)
"rr" = (
/obj/structure/bed/chair/comfy/black{
	dir = 1
	},
/turf/simulated/floor/tiled/cafe,
/area/deepmaint)
"rL" = (
/turf/simulated/floor/tiled/dark/gray_platform,
/area/deepmaint)
"sg" = (
/obj/machinery/vending/powermat,
/turf/simulated/floor/tiled/white/techfloor,
/area/deepmaint)
"sp" = (
/obj/effect/window_lwall_spawn,
/turf/simulated/floor/plating,
/area/deepmaint)
"tF" = (
/obj/structure/table/onestar,
/obj/structure/bedsheetbin,
/turf/simulated/floor/tiled/white/techfloor,
/area/deepmaint)
"tN" = (
/obj/effect/decal/cleanable/blood/gibs/body,
/turf/simulated/floor/tiled/steel/brown_perforated,
/area/deepmaint)
"tO" = (
/obj/machinery/door/airlock/multi_tile/glass{
	dir = 2
	},
/turf/simulated/floor/tiled/white/panels,
/area/deepmaint)
"ug" = (
/mob/living/carbon/superior_animal/stalker,
/turf/simulated/floor/tiled/white,
/area/deepmaint)
"ut" = (
/obj/item/modular_computer/console,
/obj/machinery/light{
	dir = 8
	},
/turf/simulated/floor/tiled/steel,
/area/deepmaint)
"uz" = (
/mob/living/simple_animal/hostile/onestar_custodian/engineer,
/turf/simulated/floor/tiled/cafe,
/area/deepmaint)
"uG" = (
/obj/structure/table/rack/shelf,
/obj/spawner/gun,
/turf/simulated/floor/tiled/derelict/white_small_edges,
/area/deepmaint)
"vd" = (
/obj/machinery/newscaster{
	pixel_x = -28
	},
/turf/simulated/floor/tiled/steel,
/area/deepmaint)
"vK" = (
/obj/machinery/vending/cola,
/turf/simulated/floor/tiled/cafe,
/area/deepmaint)
"wq" = (
/obj/structure/catwalk,
/turf/simulated/floor/plating/under,
/area/deepmaint)
"wI" = (
/obj/structure/sign/nosmoking_2{
	pixel_y = -32
	},
/obj/structure/table/standard{
	name = "plastic table frame"
	},
/obj/machinery/light,
/turf/simulated/floor/tiled/derelict/white_small_edges,
/area/deepmaint)
"wJ" = (
/obj/structure/table/standard{
	name = "plastic table frame"
	},
/obj/machinery/microwave,
/turf/simulated/floor/tiled/cafe,
/area/deepmaint)
"xg" = (
/obj/machinery/light{
	dir = 4
	},
/mob/living/simple_animal/hostile/onestar_custodian/engineer,
/turf/simulated/floor/tiled/white,
/area/deepmaint)
"yx" = (
/obj/structure/barricade,
/turf/simulated/floor/tiled/dark/techfloor,
/area/deepmaint)
"yD" = (
/obj/machinery/door/airlock/maintenance_engineering,
/turf/simulated/floor/tiled/white/panels,
/area/deepmaint)
"yY" = (
/obj/structure/bed/chair/comfy/black{
	dir = 8
	},
/obj/machinery/light{
	dir = 4
	},
/turf/simulated/floor/carpet/bcarpet,
/area/deepmaint)
"zj" = (
/obj/structure/extinguisher_cabinet{
	pixel_x = -27
	},
/turf/simulated/floor/tiled/white/techfloor,
/area/deepmaint)
"zx" = (
/obj/structure/window/reinforced{
	dir = 8
	},
/obj/structure/flora/ausbushes/ppflowers,
/obj/machinery/light,
/turf/simulated/floor/grass,
/area/deepmaint)
"AW" = (
/obj/structure/toilet{
	dir = 8
	},
/mob/living/simple_animal/hostile/onestar_custodian/engineer,
/turf/simulated/floor/tiled/steel/brown_perforated,
/area/deepmaint)
"BY" = (
/obj/structure/table/onestar,
/turf/simulated/floor/tiled/steel/brown_perforated,
/area/deepmaint)
"Cb" = (
/obj/structure/table/standard{
	name = "plastic table frame"
	},
/turf/simulated/floor/tiled/steel,
/area/deepmaint)
"CF" = (
/obj/structure/defibcabinet{
	pixel_y = 32
	},
/turf/simulated/floor/tiled/cafe,
/area/deepmaint)
"Dm" = (
/obj/effect/decal/cleanable/blood,
/turf/simulated/floor/tiled/steel/brown_perforated,
/area/deepmaint)
"Du" = (
/obj/structure/catwalk,
/obj/structure/table/rack/shelf,
/obj/item/stack/material/plasteel{
	amount = 50
	},
/obj/item/stack/material/plasteel{
	amount = 10
	},
/obj/spawner/tool_upgrade/rare,
/turf/simulated/floor/plating/under,
/area/deepmaint)
"DR" = (
/obj/structure/table/onestar,
/turf/simulated/floor/tiled/derelict/red_white_edges,
/area/deepmaint)
"DT" = (
/obj/item/remains/robot,
/turf/simulated/floor/tiled/white/bluecorner,
/area/deepmaint)
"Es" = (
/obj/structure/flora/ausbushes/ppflowers,
/turf/simulated/floor/grass,
/area/deepmaint)
"Et" = (
/obj/structure/closet/onestar/tier1/medical,
/obj/machinery/light{
	dir = 1
	},
/turf/simulated/floor/tiled/steel/techfloor,
/area/deepmaint)
"Ft" = (
/obj/machinery/atmospherics/unary/vent_pump/on{
	dir = 1
	},
/turf/simulated/floor/tiled/cafe,
/area/deepmaint)
"FI" = (
/obj/structure/window/reinforced{
	dir = 4
	},
/turf/simulated/floor/tiled/steel/techfloor,
/area/deepmaint)
"FL" = (
/mob/living/simple_animal/hostile/roomba,
/turf/simulated/floor/tiled/dark/gray_platform,
/area/deepmaint)
"FQ" = (
/obj/structure/flora/ausbushes/sunnybush,
/turf/simulated/floor/grass,
/area/deepmaint)
"FR" = (
/obj/structure/table/standard{
	name = "plastic table frame"
	},
/obj/item/newspaper,
/turf/simulated/floor/tiled/steel,
/area/deepmaint)
"Gw" = (
/obj/structure/closet/onestar/tier1/medical,
/turf/simulated/floor/tiled/derelict/red_white_edges,
/area/deepmaint)
"GD" = (
/obj/structure/table/standard{
	name = "plastic table frame"
	},
/obj/spawner/lathe_disk/advanced,
/turf/simulated/floor/tiled/steel,
/area/deepmaint)
"GJ" = (
/turf/simulated/floor/tiled/white/panels,
/area/deepmaint)
"GP" = (
/turf/simulated/floor/carpet/bcarpet,
/area/deepmaint)
"GQ" = (
/obj/structure/table/standard{
	name = "plastic table frame"
	},
/obj/spawner/junkfood,
/obj/machinery/light{
	dir = 1
	},
/turf/simulated/floor/tiled/steel,
/area/deepmaint)
"GT" = (
/obj/effect/window_lwall_spawn/smartspawn,
/turf/simulated/floor/plating,
/area/deepmaint)
"HB" = (
/obj/machinery/door/airlock/vault,
/turf/simulated/floor/tiled/white/panels,
/area/deepmaint)
"HQ" = (
/obj/effect/decal/cleanable/blood/drip,
/turf/simulated/floor/tiled/steel/brown_perforated,
/area/deepmaint)
"Id" = (
/obj/machinery/vending/cigarette,
/turf/simulated/floor/tiled/white/techfloor,
/area/deepmaint)
"Ii" = (
/turf/simulated/floor/tiled/white/cargo,
/area/deepmaint)
"IM" = (
/obj/structure/railing{
	dir = 1;
	icon_state = "railing0";
	tag = "icon-railing0 (NORTH)"
	},
/obj/machinery/porta_turret/One_star,
/turf/simulated/floor/plating/under,
/area/deepmaint)
"IU" = (
/turf/simulated/floor/tiled/white/techfloor,
/area/deepmaint)
"JI" = (
/obj/structure/bed/chair/sofa/blue/right,
/turf/simulated/floor/carpet/bcarpet,
/area/deepmaint)
"JJ" = (
/obj/structure/bed/alien,
/turf/simulated/floor/tiled/derelict/red_white_edges,
/area/deepmaint)
"JU" = (
/obj/structure/bed/chair/sofa/blue/left,
/turf/simulated/floor/carpet/bcarpet,
/area/deepmaint)
"Kk" = (
/obj/item/modular_computer/console/preset/security/camera,
/obj/machinery/light{
	dir = 1
	},
/turf/simulated/floor/tiled/derelict/white_small_edges,
/area/deepmaint)
"KD" = (
/obj/effect/decal/cleanable/dirt,
/turf/simulated/floor/tiled/white/bluecorner,
/area/deepmaint)
"KG" = (
/obj/structure/table/onestar,
/obj/spawner/tool/advanced/onestar,
/obj/machinery/light,
/turf/simulated/floor/tiled/steel/techfloor,
/area/deepmaint)
"Lj" = (
/obj/machinery/light{
	dir = 1
	},
/obj/structure/table/onestar,
/obj/spawner/tool/advanced/low_chance,
/obj/spawner/tool/advanced/low_chance,
/turf/simulated/floor/tiled/white/techfloor,
/area/deepmaint)
"Lu" = (
/obj/structure/sign/faction/neotheology_cross,
/turf/simulated/wall,
/area/deepmaint)
"Mw" = (
/turf/simulated/floor/tiled/derelict/red_white_edges,
/area/deepmaint)
"MR" = (
/obj/machinery/vending/Billomat,
/turf/simulated/floor/carpet/bcarpet,
/area/deepmaint)
"Nz" = (
/obj/structure/table/standard{
	name = "plastic table frame"
	},
/obj/item/oddity/common/old_newspaper,
/turf/simulated/floor/tiled/steel,
/area/deepmaint)
"Ou" = (
/obj/machinery/vending/coffee,
/turf/simulated/floor/tiled/white/cargo,
/area/deepmaint)
"Pq" = (
/obj/structure/table/standard{
	name = "plastic table frame"
	},
/turf/simulated/floor/tiled/cafe,
/area/deepmaint)
"Pz" = (
/obj/structure/window/reinforced{
	dir = 8
	},
/obj/structure/flora/ausbushes/stalkybush,
/turf/simulated/floor/grass,
/area/deepmaint)
"Qu" = (
/obj/machinery/door/airlock/glass,
/turf/simulated/floor/tiled/white/panels,
/area/deepmaint)
"Rd" = (
/turf/simulated/floor/tiled/steel/techfloor,
/area/deepmaint)
"Rr" = (
/obj/structure/bed/chair/office/dark{
	dir = 4
	},
/turf/simulated/floor/tiled/derelict/white_small_edges,
/area/deepmaint)
"Rz" = (
/mob/living/simple_animal/hostile/onestar_custodian/chef,
/turf/simulated/floor/tiled/white,
/area/deepmaint)
"Sh" = (
/obj/effect/decal/cleanable/dirt,
/turf/simulated/floor/carpet/bcarpet,
/area/deepmaint)
"Si" = (
/turf/simulated/floor/tiled/white,
/area/deepmaint)
"SN" = (
/turf/simulated/floor/tiled/steel/brown_perforated,
/area/deepmaint)
"SX" = (
/obj/item/remains/human,
/turf/simulated/floor/tiled/dark/gray_platform,
/area/deepmaint)
"Ti" = (
/obj/machinery/door/airlock/command,
/turf/simulated/floor/tiled/steel/monofloor,
/area/deepmaint)
"TO" = (
/obj/structure/bed/chair/office/dark{
	dir = 1
	},
/turf/simulated/floor/tiled/steel,
/area/deepmaint)
"Uc" = (
/obj/machinery/light{
	dir = 1
	},
/turf/simulated/floor/tiled/white,
/area/deepmaint)
"Uz" = (
/mob/living/simple_animal/hostile/onestar_custodian/engineer,
/turf/simulated/floor/tiled/white/bluecorner,
/area/deepmaint)
"UK" = (
/obj/effect/decal/cleanable/blood/gibs/limb,
/turf/simulated/floor/tiled/steel/techfloor,
/area/deepmaint)
"Vf" = (
/obj/machinery/door/window/brigdoor/eastleft,
/obj/machinery/atmospherics/unary/vent_pump/on{
	dir = 1
	},
/turf/simulated/floor/tiled/steel/techfloor,
/area/deepmaint)
"Vv" = (
/obj/item/remains/human,
/turf/simulated/floor/tiled/dark/techfloor,
/area/deepmaint)
"Wt" = (
/obj/structure/window/reinforced{
	dir = 8
	},
/obj/structure/flora/ausbushes,
/obj/machinery/light{
	dir = 1
	},
/turf/simulated/floor/grass,
/area/deepmaint)
"Wu" = (
/obj/structure/table/glass,
/obj/machinery/atmospherics/unary/vent_scrubber/on,
/obj/spawner/science/low_chance,
/turf/simulated/floor/carpet/bcarpet,
/area/deepmaint)
"Wy" = (
/obj/structure/table/onestar,
/obj/spawner/tool/advanced/low_chance,
/turf/simulated/floor/tiled/white/techfloor,
/area/deepmaint)
"WP" = (
/obj/structure/table/steel_reinforced,
/obj/machinery/door/window/brigdoor/eastleft,
/obj/machinery/door/window/brigdoor/westleft,
/obj/machinery/door/firedoor,
/turf/simulated/floor/tiled/white/panels,
/area/deepmaint)
"Xj" = (
/turf/simulated/wall,
/area/deepmaint)
"Xm" = (
/mob/living/simple_animal/hostile/onestar_custodian/engineer,
/turf/simulated/floor/tiled/derelict/red_white_edges,
/area/deepmaint)
"Xu" = (
/obj/machinery/door/airlock/security,
/turf/simulated/floor/tiled/white/panels,
/area/deepmaint)
"Yr" = (
/obj/structure/bed/chair/comfy/black,
/turf/simulated/floor/tiled/cafe,
/area/deepmaint)
"Yu" = (
/turf/simulated/floor/plating/under,
/area/deepmaint)
"YL" = (
/turf/simulated/floor/tiled/derelict/white_small_edges,
/area/deepmaint)
"Zp" = (
/obj/structure/extinguisher_cabinet{
	pixel_x = 26
	},
/turf/simulated/floor/tiled/white,
/area/deepmaint)
"Zt" = (
/turf/simulated/wall/r_wall,
/area/deepmaint)
"ZX" = (
/obj/structure/cyberplant,
/turf/simulated/floor/carpet/bcarpet,
/area/deepmaint)

(1,1,1) = {"
rL
rL
rL
rL
FL
rL
rL
rL
rL
rL
rL
rL
rL
rL
rL
rL
rL
rL
rL
dN
rL
"}
(2,1,1) = {"
rL
Zt
Xj
Zt
Wt
Pz
qt
zx
Zt
Zt
Zt
Zt
Zt
Zt
Zt
Zt
Zt
Zt
Zt
Zt
rL
"}
(3,1,1) = {"
rL
Zt
Yu
Zt
lm
hQ
Es
FQ
Zt
ut
TO
bN
TO
ut
TO
vd
Xj
nK
kz
Zt
rL
"}
(4,1,1) = {"
rL
Zt
Yu
Zt
GT
GT
GT
GT
Zt
GD
oy
FR
bQ
ev
nG
kY
Xj
gX
gX
Zt
rL
"}
(5,1,1) = {"
rL
Zt
Yu
Xj
cG
Yr
dE
rr
Xj
bN
TO
bN
TO
bN
TO
rm
nv
YL
YL
Zt
rL
"}
(6,1,1) = {"
rL
Zt
gH
Xj
da
cq
uz
Ft
Xj
GQ
nG
Cb
rm
Nz
rm
nG
Xj
gX
cE
Zt
rL
"}
(7,1,1) = {"
rL
Zt
cM
Xj
vK
pH
pH
Pq
sp
dC
GP
bf
Uz
GP
GP
GP
Xj
Xj
Xj
Zt
rL
"}
(8,1,1) = {"
rL
Zt
wq
Xj
Xj
CF
pH
wJ
sp
MR
GP
KD
bf
GP
GP
Sh
Xj
uG
bJ
Zt
rL
"}
(9,1,1) = {"
rL
Zt
wq
Du
Xj
pH
pH
Pq
sp
JI
gB
DT
bf
Sh
GP
GP
Xj
YL
YL
Zt
rL
"}
(10,1,1) = {"
rL
Zt
yD
Xj
Xj
Xj
pH
mb
sp
JU
Wu
bf
KD
GP
GP
GP
Xu
YL
YL
Zt
rL
"}
(11,1,1) = {"
rL
Zt
IU
zj
IU
ps
kK
Si
Xj
ZX
yY
bf
bf
GP
GP
GP
Xj
YL
YL
Zt
rL
"}
(12,1,1) = {"
rL
Zt
Wy
mK
IU
sp
Si
Si
Xj
sp
sp
GJ
tO
sp
sp
Xj
Xj
YL
YL
Zt
rL
"}
(13,1,1) = {"
rL
Zt
Lj
IU
IU
Qu
Si
Si
Si
Si
ug
Si
Si
oY
Si
Xj
Kk
Rr
wI
Zt
rL
"}
(14,1,1) = {"
rL
Zt
sg
IU
IU
Xj
Si
xg
Si
Zp
Si
Si
Si
Si
Si
Xj
kS
WP
kS
Zt
rL
"}
(15,1,1) = {"
rL
Zt
Id
IU
tF
Zt
Zt
Zt
Ti
Zt
Zt
Zt
Si
Si
Si
HB
yx
dl
dl
HB
SX
"}
(16,1,1) = {"
rL
Zt
Zt
Qu
Zt
Xj
Et
hn
Rd
UK
KG
Zt
Si
Si
Si
HB
yx
dl
Vv
HB
rL
"}
(17,1,1) = {"
rL
Zt
Gw
Mw
DR
Xj
bg
FI
pq
FI
Vf
Zt
Uc
Rz
om
Xj
sp
sp
sp
Zt
rL
"}
(18,1,1) = {"
rL
Zt
Mw
Mw
hl
Lu
eh
tN
HQ
SN
Dm
Zt
Ou
Ii
Ii
Xj
wq
IM
Yu
Zt
rL
"}
(19,1,1) = {"
rL
Zt
JJ
Xm
DR
Xj
BY
HQ
SN
Dm
AW
Zt
os
Ii
Ii
yD
wq
jm
Yu
Zt
rL
"}
(20,1,1) = {"
rL
Zt
Zt
Zt
Zt
Zt
Zt
Zt
Zt
Zt
Zt
Zt
Zt
Zt
Zt
Zt
Zt
Zt
Zt
Zt
rL
"}
(21,1,1) = {"
rL
rL
rL
rL
rL
rL
rL
rL
rL
rL
rL
rL
FL
rL
rL
rL
rL
rL
rL
rL
rL
"}
