"aa" = (/turf/template_noop,/area/map_template/oldpod)
"ab" = (/obj/structure/shuttle/engine/propulsion{dir = 1},/turf/simulated/floor/plating,/area/map_template/oldpod)
"ac" = (/turf/simulated/shuttle/wall{icon_state = "wall3"},/area/map_template/oldpod)
"ad" = (/turf/simulated/floor/plating,/area/map_template/oldpod)
"ae" = (/turf/simulated/wall,/area/map_template/oldpod)
"af" = (/obj/machinery/door/firedoor,/obj/effect/window_lwall_spawn/phoron,/turf/simulated/floor/plating,/area/map_template/oldpod)
"ag" = (/obj/structure/shuttle/engine/heater{icon_state = "heater"; dir = 1},/turf/simulated/wall,/area/map_template/oldpod)
"ah" = (/obj/effect/floor_decal/industrial/outline/yellow,/obj/machinery/portable_atmospherics/canister/air/airlock,/obj/machinery/atmospherics/portables_connector{dir = 4},/obj/structure/window/reinforced{dir = 8},/obj/effect/decal/cleanable/dirt,/turf/simulated/floor/plating,/area/map_template/oldpod)
"ai" = (/obj/effect/decal/cleanable/dirt,/turf/simulated/floor/tiled/dark/bluecorner,/area/map_template/oldpod)
"aj" = (/obj/effect/floor_decal/industrial/outline/yellow,/obj/machinery/portable_atmospherics/canister/empty,/obj/structure/window/reinforced{dir = 4},/obj/machinery/atmospherics/portables_connector{dir = 8},/turf/simulated/floor/plating,/area/map_template/oldpod)
"ak" = (/obj/structure/bed,/obj/effect/decal/cleanable/blood,/obj/effect/decal/cleanable/dirt,/turf/simulated/floor/tiled/dark/bluecorner,/area/map_template/oldpod)
"al" = (/obj/structure/bed,/obj/effect/decal/cleanable/dirt,/obj/effect/decal/cleanable/dirt,/obj/effect/decal/cleanable/dirt,/turf/simulated/floor/tiled/dark/bluecorner,/area/map_template/oldpod)
"am" = (/obj/effect/decal/cleanable/dirt,/obj/effect/decal/cleanable/dirt,/obj/effect/decal/cleanable/dirt,/turf/simulated/floor/tiled/dark/bluecorner,/area/map_template/oldpod)
"an" = (/obj/effect/decal/cleanable/blood,/obj/effect/decal/cleanable/dirt,/turf/simulated/floor/tiled/dark/bluecorner,/area/map_template/oldpod)
"ao" = (/obj/structure/bed/chair/shuttle{tag = "icon-shuttle_chair_preview (WEST)"; icon_state = "shuttle_chair_preview"; dir = 8},/obj/structure/window/reinforced{dir = 4},/obj/effect/decal/cleanable/dirt,/turf/simulated/floor/tiled/dark/bluecorner,/area/map_template/oldpod)
"ap" = (/obj/structure/bed/chair/shuttle{tag = "icon-shuttle_chair_preview (NORTH)"; icon_state = "shuttle_chair_preview"; dir = 4},/obj/structure/window/reinforced{dir = 8},/obj/effect/decal/cleanable/dirt,/turf/simulated/floor/tiled/dark/bluecorner,/area/map_template/oldpod)
"aq" = (/obj/effect/decal/cleanable/blood/drip,/obj/effect/decal/cleanable/dirt,/obj/effect/decal/cleanable/dirt,/turf/simulated/floor/tiled/dark/bluecorner,/area/map_template/oldpod)
"ar" = (/obj/machinery/light/small{dir = 8},/obj/effect/decal/cleanable/dirt,/obj/effect/decal/cleanable/dirt,/obj/spawner/pack/tech_loot,/turf/simulated/floor/tiled/dark/bluecorner,/area/map_template/oldpod)
"as" = (/obj/effect/decal/cleanable/dirt,/obj/effect/decal/cleanable/dirt,/obj/effect/decal/cleanable/dirt,/obj/effect/decal/cleanable/dirt,/turf/simulated/floor/tiled/dark/bluecorner,/area/map_template/oldpod)
"at" = (/obj/effect/decal/cleanable/blood/drip,/obj/effect/decal/cleanable/blood,/obj/effect/decal/cleanable/dirt,/obj/effect/decal/cleanable/dirt,/turf/simulated/floor/tiled/dark/bluecorner,/area/map_template/oldpod)
"au" = (/obj/machinery/atmospherics/unary/vent_pump/on{dir = 1},/obj/effect/decal/cleanable/dirt,/obj/effect/decal/cleanable/dirt,/obj/effect/decal/cleanable/dirt,/turf/simulated/floor/tiled/dark/bluecorner,/area/map_template/oldpod)
"av" = (/obj/machinery/atmospherics/unary/vent_scrubber/on{dir = 1},/obj/effect/decal/cleanable/dirt,/obj/effect/decal/cleanable/dirt,/turf/simulated/floor/tiled/dark/bluecorner,/area/map_template/oldpod)
"aw" = (/obj/machinery/light/small{dir = 4},/obj/effect/decal/cleanable/dirt,/obj/effect/decal/cleanable/dirt,/turf/simulated/floor/tiled/dark/bluecorner,/area/map_template/oldpod)
"ax" = (/obj/machinery/door/firedoor,/obj/effect/decal/cleanable/dirt,/obj/effect/window_lwall_spawn/phoron,/turf/simulated/floor/plating,/area/map_template/oldpod)
"ay" = (/obj/item/frame/air_alarm,/obj/effect/decal/cleanable/dirt,/obj/effect/decal/cleanable/dirt,/turf/simulated/floor/tiled/dark/bluecorner,/area/map_template/oldpod)
"az" = (/obj/effect/decal/cleanable/blood/drip,/obj/effect/decal/cleanable/dirt,/obj/effect/decal/cleanable/dirt,/obj/effect/decal/cleanable/dirt,/turf/simulated/floor/tiled/dark/bluecorner,/area/map_template/oldpod)
"aA" = (/obj/spawner/firstaid,/obj/effect/decal/cleanable/dirt,/obj/effect/decal/cleanable/dirt,/obj/effect/decal/cleanable/dirt,/obj/effect/decal/cleanable/dirt,/turf/simulated/floor/tiled/dark/bluecorner,/area/map_template/oldpod)
"aB" = (/obj/effect/decal/cleanable/blood/drip,/obj/effect/decal/cleanable/dirt,/obj/effect/decal/cleanable/dirt,/obj/effect/decal/cleanable/dirt,/obj/effect/decal/cleanable/dirt,/turf/simulated/floor/tiled/dark/bluecorner,/area/map_template/oldpod)
"aC" = (/obj/item/clothing/suit/space/emergency,/obj/effect/decal/cleanable/dirt,/obj/effect/decal/cleanable/dirt,/turf/simulated/floor/tiled/dark/bluecorner,/area/map_template/oldpod)
"aD" = (/obj/structure/window/reinforced{dir = 1},/obj/structure/table/standard{name = "plastic table frame"},/obj/effect/decal/cleanable/dirt,/obj/spawner/pack/tech_loot,/turf/simulated/floor/tiled/dark/bluecorner,/area/map_template/oldpod)
"aE" = (/obj/structure/window/reinforced{dir = 1},/obj/effect/decal/cleanable/dirt,/obj/structure/table,/turf/simulated/floor/tiled/dark/bluecorner,/area/map_template/oldpod)
"aF" = (/obj/effect/decal/cleanable/dirt,/obj/effect/decal/cleanable/dirt,/turf/simulated/floor/tiled/dark/bluecorner,/area/map_template/oldpod)
"aG" = (/obj/effect/decal/cleanable/blood/drip,/obj/effect/decal/cleanable/blood,/obj/effect/decal/cleanable/dirt,/turf/simulated/floor/tiled/dark/bluecorner,/area/map_template/oldpod)
"aH" = (/obj/structure/cable/cyan{d2 = 4; icon_state = "0-4"},/obj/item/frame/apc,/obj/effect/decal/cleanable/dirt,/obj/spawner/pack/tech_loot,/turf/simulated/floor/tiled/dark/bluecorner,/area/map_template/oldpod)
"aI" = (/obj/structure/cable/cyan{d1 = 2; d2 = 8; icon_state = "2-8"},/obj/effect/decal/cleanable/dirt,/obj/effect/decal/cleanable/dirt,/turf/simulated/floor/tiled/dark/bluecorner,/area/map_template/oldpod)
"aJ" = (/obj/item/weapon/gun/energy/retro,/obj/effect/decal/cleanable/dirt,/obj/effect/decal/cleanable/dirt,/turf/simulated/floor/tiled/dark/bluecorner,/area/map_template/oldpod)
"aK" = (/obj/effect/decal/cleanable/blood/drip,/obj/effect/decal/cleanable/dirt,/turf/simulated/floor/tiled/dark/bluecorner,/area/map_template/oldpod)
"aL" = (/obj/effect/decal/cleanable/blood/drip,/obj/effect/decal/cleanable/blood/drip,/obj/effect/decal/cleanable/dirt,/obj/effect/decal/cleanable/dirt,/obj/effect/decal/cleanable/dirt,/obj/effect/decal/cleanable/dirt,/turf/simulated/floor/tiled/dark/bluecorner,/area/map_template/oldpod)
"aM" = (/obj/item/weapon/material/wirerod,/obj/item/weapon/material/shard,/obj/effect/decal/cleanable/blood,/obj/effect/decal/cleanable/dirt,/turf/simulated/floor/tiled/dark/bluecorner,/area/map_template/oldpod)
"aN" = (/obj/machinery/door/firedoor,/obj/structure/grille,/obj/item/weapon/material/shard,/obj/item/weapon/material/shard,/obj/item/weapon/material/shard,/obj/item/weapon/material/shard,/turf/simulated/floor/plating,/area/map_template/oldpod)
"aO" = (/obj/machinery/door/airlock/external{name = "escape pod airlock"},/turf/simulated/floor/plating,/area/map_template/oldpod)
"aP" = (/obj/effect/floor_decal/industrial/outline/yellow,/obj/structure/cable/cyan,/obj/machinery/light/small{dir = 8},/obj/effect/floor_decal/industrial/warning{icon_state = "warning"; dir = 5},/turf/simulated/floor/plating,/area/map_template/oldpod)
"aQ" = (/obj/effect/floor_decal/industrial/warning{icon_state = "warning"; dir = 9},/obj/structure/window/reinforced{dir = 8},/obj/structure/window/reinforced{dir = 1},/obj/structure/table/standard{name = "plastic table frame"},/obj/item/weapon/storage/firstaid/surgery,/obj/effect/decal/cleanable/dirt,/turf/simulated/floor/tiled/dark/bluecorner,/area/map_template/oldpod)
"aR" = (/obj/effect/floor_decal/industrial/warning{dir = 1},/obj/effect/decal/cleanable/dirt,/obj/effect/decal/cleanable/dirt,/obj/effect/decal/cleanable/dirt,/turf/simulated/floor/tiled/dark/bluecorner,/area/map_template/oldpod)
"aS" = (/obj/effect/floor_decal/industrial/warning{icon_state = "warning"; dir = 5},/obj/structure/window/reinforced{dir = 1},/obj/structure/closet/crate/freezer/rations,/obj/effect/decal/cleanable/dirt,/turf/simulated/floor/tiled/dark/bluecorner,/area/map_template/oldpod)
"aU" = (/obj/effect/floor_decal/industrial/warning{dir = 9},/turf/simulated/floor/plating,/area/map_template/oldpod)
"aV" = (/obj/effect/floor_decal/industrial/warning{dir = 5},/obj/machinery/light/small{dir = 4},/turf/simulated/floor/plating,/area/map_template/oldpod)
"aW" = (/obj/machinery/power/terminal{icon_state = "term"; dir = 1},/obj/structure/cable/cyan{d2 = 2; icon_state = "0-2"},/obj/effect/floor_decal/industrial/warning{dir = 4},/obj/structure/closet/crate,/obj/item/weapon/tank/oxygen,/turf/simulated/floor/plating,/area/map_template/oldpod)
"aX" = (/obj/effect/floor_decal/industrial/warning{dir = 8},/obj/structure/window/reinforced{dir = 8},/obj/machinery/optable,/obj/effect/decal/cleanable/dirt,/obj/effect/decal/cleanable/dirt,/obj/effect/decal/cleanable/blood,/turf/simulated/floor/tiled/dark/bluecorner,/area/map_template/oldpod)
"aZ" = (/obj/machinery/sleeper{dir = 8},/obj/effect/floor_decal/industrial/warning{dir = 4},/obj/machinery/light/small{dir = 4},/obj/effect/decal/cleanable/dirt,/turf/simulated/floor/tiled/dark/bluecorner,/area/map_template/oldpod)
"ba" = (/obj/effect/floor_decal/industrial/warning{dir = 10},/obj/item/clothing/suit/space/emergency,/turf/simulated/floor/plating,/area/map_template/oldpod)
"bb" = (/obj/effect/floor_decal/industrial/warning{dir = 6},/turf/simulated/floor/plating,/area/map_template/oldpod)
"bc" = (/obj/machinery/power/port_gen/pacman,/obj/structure/cable/cyan,/obj/effect/floor_decal/industrial/warning{dir = 4},/turf/simulated/floor/plating,/area/map_template/oldpod)
"bd" = (/obj/effect/decal/cleanable/blood,/turf/simulated/floor/tiled/dark/bluecorner,/area/map_template/oldpod)
"be" = (/obj/effect/floor_decal/industrial/warning{icon_state = "warning"; dir = 10},/obj/structure/window/reinforced{dir = 8},/obj/structure/table/standard{name = "plastic table frame"},/obj/spawner/firstaid,/obj/spawner/firstaid,/obj/effect/decal/cleanable/dirt,/turf/simulated/floor/tiled/dark/bluecorner,/area/map_template/oldpod)
"bf" = (/obj/effect/floor_decal/industrial/warning,/obj/effect/decal/cleanable/dirt,/obj/effect/decal/cleanable/dirt,/obj/effect/decal/cleanable/dirt,/obj/spawner/pack/tech_loot,/turf/simulated/floor/tiled/dark/bluecorner,/area/map_template/oldpod)
"bg" = (/obj/machinery/sleeper{dir = 8},/obj/effect/floor_decal/industrial/warning{icon_state = "warning"; dir = 6},/obj/effect/decal/cleanable/dirt,/obj/effect/decal/cleanable/dirt,/obj/effect/decal/cleanable/dirt,/turf/simulated/floor/tiled/dark/bluecorner,/area/map_template/oldpod)

(1,1,1) = {"
aaabaeaeaeafaeaeabaa
aeagaeahaiaiajaeagae
aeakalalamanaoapaqae
aearaFatauavaoapawae
axayazaAaBaCaDaEaFaf
afaGamaHaIaJaKaLaMaN
aeadaOacaPaiaQaRaSae
aeaUaVacaWaKaXasaZae
aebabbacbcbdbebfbgae
aeaeaOacaeafaeaeaeae
"}
