"a" = (/obj/structure/bed/chair/wood,/obj/effect/decal/cleanable/cobweb,/turf/simulated/floor/carpet/gaycarpet,/area/template_noop)
"b" = (/turf/simulated/wall/iron,/area/template_noop)
"c" = (/obj/machinery/door/unpowered/simple/uranium,/turf/template_noop,/area/template_noop)
"d" = (/turf/simulated/wall/uranium,/area/template_noop)
"e" = (/obj/structure/bed/chair/wood,/turf/simulated/floor/carpet/gaycarpet,/area/template_noop)
"f" = (/turf/simulated/floor/carpet/gaycarpet,/area/template_noop)
"g" = (/obj/item/trash/candle,/turf/simulated/floor/carpet/gaycarpet,/area/template_noop)
"h" = (/obj/effect/window_lwall_spawn/smartspawnphoron,/turf/simulated/floor/plating,/area/template_noop)
"i" = (/obj/machinery/artifact,/turf/simulated/floor/reinforced,/area/template_noop)

(1,1,1) = {"
dbbcbbd
baefeeb
beefeeb
dfffffd
bghhhgb
bghihgb
dbbdbbd
"}
