"a" = (/mob/living/carbon/superior_animal/roach/fuhrer,/turf/simulated/floor/tiled/techmaint,/area/deepmaint)
"b" = (/obj/structure/disposalpipe/segment,/turf/simulated/wall,/area/deepmaint)
"c" = (/turf/simulated/wall,/area/deepmaint)
"d" = (/turf/simulated/floor/tiled/techmaint,/area/deepmaint)
"e" = (/obj/spawner/scrap/sparse/low_chance,/obj/structure/catwalk,/turf/simulated/floor/plating/under,/area/deepmaint)
"f" = (/obj/structure/catwalk,/obj/item/weapon/material/shard,/obj/item/stack/rods,/turf/simulated/floor/plating/under,/area/deepmaint)
"g" = (/obj/spawner/scrap/sparse/low_chance,/obj/structure/catwalk,/obj/machinery/atmospherics/pipe/zpipe/up/scrubbers,/obj/machinery/atmospherics/pipe/zpipe/up/supply,/obj/structure/disposalpipe/segment,/obj/item/stack/rods,/turf/simulated/floor/plating/under,/area/deepmaint)
"h" = (/obj/spawner/mob/roaches/cluster,/obj/spawner/mob/roaches/cluster,/turf/simulated/floor/tiled/techmaint,/area/deepmaint)
"i" = (/obj/spawner/scrap/sparse/low_chance,/obj/spawner/material/resources/rare/low_chance,/obj/structure/catwalk,/turf/simulated/floor/plating/under,/area/deepmaint)
"j" = (/obj/item/weapon/material/shard,/turf/simulated/floor/plating/under,/area/deepmaint)
"k" = (/obj/spawner/scrap/sparse,/obj/machinery/atmospherics/pipe/simple/visible/scrubbers,/obj/machinery/atmospherics/pipe/simple/visible/supply,/obj/structure/disposalpipe/segment,/turf/simulated/floor/plating/under,/area/deepmaint)
"l" = (/obj/spawner/scrap/sparse,/obj/structure/railing{dir = 1},/obj/structure/window/basic,/obj/item/stack/rods,/turf/simulated/floor/plating/under,/area/deepmaint)
"m" = (/obj/spawner/scrap/dense,/obj/spawner/tool/advanced/onestar/low_chance,/obj/spawner/mob/roaches/cluster,/turf/simulated/floor/plating/under,/area/deepmaint)
"n" = (/obj/spawner/scrap/sparse,/obj/spawner/pack/rare/low_chance,/turf/simulated/floor/plating/under,/area/deepmaint)
"o" = (/obj/spawner/scrap/sparse,/obj/spawner/pack/rare/low_chance,/obj/spawner/mob/roaches/cluster,/obj/item/weapon/material/shard,/obj/machinery/atmospherics/pipe/simple/visible/scrubbers,/obj/machinery/atmospherics/pipe/simple/visible/supply,/obj/structure/disposalpipe/segment,/turf/simulated/floor/plating/under,/area/deepmaint)
"p" = (/turf/simulated/floor/plating/under,/area/deepmaint)
"q" = (/obj/spawner/scrap/dense,/obj/spawner/tool_upgrade/rare,/obj/spawner/pack/tech_loot/onestar,/obj/spawner/mob/roaches/cluster,/turf/simulated/floor/plating/under,/area/deepmaint)
"r" = (/obj/spawner/scrap/sparse/low_chance,/obj/structure/catwalk,/obj/item/weapon/material/shard,/turf/simulated/floor/plating/under,/area/deepmaint)
"s" = (/obj/spawner/scrap/sparse,/obj/structure/railing{dir = 8},/obj/structure/window/basic{dir = 4},/turf/simulated/floor/plating/under,/area/deepmaint)
"t" = (/obj/spawner/contraband/low_chance,/turf/simulated/floor/plating/under,/area/deepmaint)
"u" = (/obj/machinery/atmospherics/pipe/simple/visible/scrubbers,/obj/machinery/atmospherics/pipe/simple/visible/supply,/obj/structure/disposalpipe/segment,/obj/structure/plushie/ian,/turf/simulated/floor/plating/under,/area/deepmaint)
"v" = (/obj/structure/scrap_cube,/turf/simulated/floor/plating/under,/area/deepmaint)
"w" = (/obj/spawner/scrap/sparse,/obj/item/weapon/material/shard,/turf/simulated/floor/plating/under,/area/deepmaint)
"x" = (/obj/spawner/scrap/sparse/low_chance,/obj/structure/catwalk,/obj/machinery/atmospherics/pipe/simple/visible{dir = 4},/turf/simulated/floor/plating/under,/area/deepmaint)
"y" = (/obj/spawner/scrap/sparse,/obj/machinery/atmospherics/pipe/simple/visible{dir = 4},/turf/simulated/floor/plating/under,/area/deepmaint)
"z" = (/obj/spawner/scrap/sparse,/obj/spawner/pack/rare/low_chance,/obj/spawner/mob/roaches/cluster,/obj/machinery/atmospherics/pipe/simple/visible{dir = 4},/turf/simulated/floor/plating/under,/area/deepmaint)
"A" = (/obj/machinery/atmospherics/pipe/simple/visible{dir = 4},/obj/item/stack/rods,/turf/simulated/floor/plating/under,/area/deepmaint)
"B" = (/obj/machinery/atmospherics/pipe/simple/visible/scrubbers,/obj/machinery/atmospherics/pipe/simple/visible/supply,/obj/machinery/atmospherics/pipe/simple/visible{dir = 10},/obj/structure/disposalpipe/junction{dir = 1},/turf/simulated/floor/plating/under,/area/deepmaint)
"C" = (/obj/structure/disposalpipe/segment{dir = 4},/turf/simulated/floor/plating/under,/area/deepmaint)
"D" = (/obj/spawner/scrap/sparse,/obj/spawner/pack/rare/low_chance,/obj/spawner/mob/roaches/cluster,/obj/structure/disposalpipe/segment{dir = 2; icon_state = "pipe-c"},/turf/simulated/floor/plating/under,/area/deepmaint)
"E" = (/obj/spawner/scrap/sparse,/obj/structure/railing{dir = 4},/obj/structure/window/basic{dir = 8},/obj/item/stack/rods,/turf/simulated/floor/plating/under,/area/deepmaint)
"F" = (/obj/item/weapon/material/shard,/obj/item/stack/rods,/turf/simulated/floor/plating/under,/area/deepmaint)
"G" = (/obj/spawner/contraband/low_chance,/mob/living/carbon/superior_animal/roach/kaiser,/turf/simulated/floor/plating/under,/area/deepmaint)
"H" = (/obj/machinery/atmospherics/pipe/simple/visible/scrubbers,/obj/machinery/atmospherics/pipe/simple/visible/supply,/obj/machinery/atmospherics/pipe/simple/visible,/obj/structure/disposalpipe/segment,/turf/simulated/floor/plating/under,/area/deepmaint)
"I" = (/obj/spawner/scrap/sparse,/obj/spawner/pack/rare/low_chance,/obj/structure/disposalpipe/segment{dir = 1; icon_state = "pipe-c"},/turf/simulated/floor/plating/under,/area/deepmaint)
"J" = (/obj/structure/railing{dir = 4},/obj/structure/disposalpipe/segment{dir = 4},/obj/structure/window/basic{dir = 8},/turf/simulated/floor/plating/under,/area/deepmaint)
"K" = (/obj/spawner/scrap/sparse/low_chance,/obj/structure/catwalk,/obj/structure/disposalpipe/segment{dir = 4},/turf/simulated/floor/plating/under,/area/deepmaint)
"L" = (/obj/structure/disposalpipe/segment{dir = 4},/turf/simulated/wall,/area/deepmaint)
"M" = (/obj/structure/catwalk,/obj/item/weapon/material/shard,/turf/simulated/floor/plating/under,/area/deepmaint)
"N" = (/obj/spawner/scrap/dense,/obj/spawner/tool_upgrade/rare,/obj/spawner/mob/roaches/cluster,/turf/simulated/floor/plating/under,/area/deepmaint)
"O" = (/obj/spawner/mob/roaches/cluster,/obj/machinery/atmospherics/pipe/simple/visible/scrubbers,/obj/machinery/atmospherics/pipe/simple/visible/supply,/obj/machinery/atmospherics/pipe/simple/visible,/obj/structure/disposalpipe/segment,/turf/simulated/floor/plating/under,/area/deepmaint)
"P" = (/obj/spawner/scrap/sparse,/obj/spawner/pack/rare/low_chance,/obj/item/stack/rods,/turf/simulated/floor/plating/under,/area/deepmaint)
"Q" = (/obj/spawner/scrap/dense,/obj/spawner/rig_module/rare/low_chance,/obj/spawner/rig/low_chance,/obj/spawner/mob/roaches/cluster,/turf/simulated/floor/plating/under,/area/deepmaint)
"R" = (/obj/structure/catwalk,/turf/simulated/floor/plating/under,/area/deepmaint)
"S" = (/obj/structure/railing,/obj/structure/window/basic{dir = 1},/turf/simulated/floor/plating/under,/area/deepmaint)
"T" = (/obj/spawner/scrap/sparse,/obj/machinery/atmospherics/pipe/simple/visible/scrubbers,/obj/machinery/atmospherics/pipe/simple/visible/supply,/obj/machinery/atmospherics/pipe/simple/visible,/obj/structure/disposalpipe/segment,/obj/structure/window/basic{dir = 1},/turf/simulated/floor/plating/under,/area/deepmaint)
"U" = (/obj/spawner/scrap/sparse,/obj/structure/railing,/obj/structure/window/basic{dir = 1},/turf/simulated/floor/plating/under,/area/deepmaint)
"V" = (/obj/spawner/scrap/sparse/low_chance,/obj/structure/catwalk,/obj/machinery/atmospherics/pipe/simple/visible/scrubbers,/obj/machinery/atmospherics/pipe/simple/visible/supply,/obj/machinery/atmospherics/pipe/simple/visible,/obj/structure/disposalpipe/segment,/turf/simulated/floor/plating/under,/area/deepmaint)
"W" = (/obj/spawner/scrap/sparse/low_chance,/obj/spawner/material/resources/rare/low_chance,/obj/structure/catwalk,/obj/item/weapon/material/shard,/turf/simulated/floor/plating/under,/area/deepmaint)

(1,1,1) = {"
ahcccbcccha
hdefegieedh
ceccjklccec
cicmnopqcrc
cesptutvwic
cxyzABCDEec
ciFnGHtIJKL
cMcNnOPQcRc
ceccSTUccec
hdeReVrWedh
ahcccbcccha
"}
