"a" = (/turf/simulated/floor/greengrid,/area/template_noop)
"b" = (/turf/simulated/wall/sandstonediamond,/area/template_noop)
"c" = (/turf/simulated/floor/tiled/dark/techfloor_grid,/area/template_noop)
"d" = (/obj/machinery/artifact,/turf/simulated/floor/tiled/dark/techfloor_grid,/area/template_noop)
"e" = (/turf/template_noop,/area/template_noop)
"f" = (/obj/item/weapon/stock_parts/scanning_module/alien,/obj/item/weapon/stock_parts/capacitor/alien_capacitor,/obj/item/weapon/stock_parts/manipulator/alien,/obj/item/weapon/stock_parts/matter_bin/alien,/obj/item/weapon/stock_parts/micro_laser/alien,/turf/simulated/floor/tiled/dark/techfloor_grid,/area/template_noop)

(1,1,1) = {"
eeebeee
eeaaaee
eaacaae
bacdfab
eaacaae
eeaaaee
eeebeee
"}
