"aa" = (/turf/simulated/wall/untinted/onestar_reinforced,/area/template_noop)
"ab" = (/obj/effect/decal/cleanable/cobweb,/obj/effect/decal/cleanable/blood,/obj/effect/decal/cleanable/mucus,/turf/simulated/floor/tiled/dark/brown_platform,/area/template_noop)
"ac" = (/obj/effect/decal/cleanable/mucus,/turf/simulated/floor/tiled/dark/brown_platform,/area/template_noop)
"ad" = (/obj/effect/decal/cleanable/blood,/obj/effect/decal/cleanable/blood/drip,/turf/simulated/floor/tiled/dark/brown_platform,/area/template_noop)
"ae" = (/obj/machinery/artifact,/obj/effect/decal/cleanable/cobweb2,/turf/simulated/floor/tiled/dark/brown_platform,/area/template_noop)
"af" = (/turf/template_noop,/area/template_noop)
"ag" = (/turf/simulated/floor/tiled/white,/area/template_noop)
"ah" = (/turf/simulated/floor/tiled/dark/brown_platform,/area/template_noop)
"ai" = (/obj/machinery/floodlight,/turf/template_noop,/area/template_noop)
"aj" = (/obj/effect/decal/cleanable/spiderling_remains,/turf/simulated/floor/tiled/white,/area/template_noop)
"ak" = (/obj/structure/table/onestar,/turf/template_noop,/area/template_noop)
"al" = (/obj/effect/decal/cleanable/mucus,/mob/living/simple_animal/hostile/creature,/turf/simulated/floor/tiled/dark/brown_platform,/area/template_noop)
"am" = (/obj/item/trash,/obj/effect/decal/cleanable/blood,/obj/effect/decal/cleanable/mucus,/mob/living/simple_animal/hostile/creature,/turf/simulated/floor/tiled/dark/brown_platform,/area/template_noop)
"an" = (/obj/effect/decal/cleanable/blood,/turf/simulated/floor/tiled/dark/brown_platform,/area/template_noop)
"ao" = (/obj/spawner/junk,/turf/template_noop,/area/template_noop)
"ap" = (/obj/structure/closet/crate,/turf/template_noop,/area/template_noop)
"aq" = (/obj/item/trash,/obj/item/trash,/turf/simulated/floor/tiled/dark/brown_platform,/area/template_noop)
"ar" = (/obj/structure/closet/crate/trashcart,/turf/template_noop,/area/template_noop)
"as" = (/obj/structure/closet/crate/freezer/rations,/turf/template_noop,/area/template_noop)
"at" = (/obj/machinery/door/airlock/vault{name = "Door"},/obj/item/weapon/beartrap{deployed = 1; icon_state = "beartrap1"},/turf/simulated/floor/tiled/dark/brown_platform,/area/template_noop)
"au" = (/obj/effect/window_lwall_spawn/phoron,/turf/simulated/floor/plating,/area/template_noop)
"av" = (/obj/machinery/door/airlock/vault{name = "Door"; welded = null},/turf/simulated/floor/tiled/dark/brown_platform,/area/template_noop)
"aw" = (/obj/machinery/door/airlock/vault{name = "Door"},/turf/simulated/floor/tiled/dark/brown_platform,/area/template_noop)
"ax" = (/obj/structure/bed/chair/office/light,/turf/simulated/floor/tiled/white,/area/template_noop)
"ay" = (/obj/structure/table/onestar,/obj/spawner/oddities,/turf/simulated/floor/tiled/white,/area/template_noop)
"az" = (/obj/item/weapon/virusdish/random,/obj/structure/table/onestar,/turf/simulated/floor/tiled/white,/area/template_noop)
"aA" = (/obj/effect/decal/cleanable/blood,/turf/simulated/floor/tiled/white,/area/template_noop)
"aB" = (/obj/machinery/door/unpowered/simple/wood,/turf/simulated/floor/tiled/dark/brown_platform,/area/template_noop)
"aC" = (/obj/machinery/door/airlock/external,/turf/simulated/floor/tiled/dark/brown_platform,/area/template_noop)
"aD" = (/obj/machinery/replicator,/turf/simulated/floor/tiled/dark/brown_platform,/area/template_noop)
"aE" = (/obj/structure/bookcase/manuals/xenoarchaeology,/turf/simulated/floor/tiled/dark/brown_platform,/area/template_noop)
"aF" = (/obj/machinery/vending/snack,/turf/simulated/floor/tiled/dark/brown_platform,/area/template_noop)
"aG" = (/obj/effect/decal/cleanable/vomit,/turf/simulated/floor/tiled/dark/brown_platform,/area/template_noop)
"aH" = (/obj/effect/decal/cleanable/cobweb2,/obj/structure/closet/cabinet,/turf/simulated/floor/tiled/dark/brown_platform,/area/template_noop)
"aI" = (/obj/structure/table/rack,/obj/item/clothing/mask/gas,/obj/item/weapon/tank/oxygen,/turf/simulated/floor/tiled/dark/brown_platform,/area/template_noop)
"aJ" = (/obj/item/trash,/turf/simulated/floor/tiled/white,/area/template_noop)
"aK" = (/obj/structure/extinguisher_cabinet{pixel_x = -32},/turf/simulated/floor/tiled/dark/brown_platform,/area/template_noop)
"aL" = (/obj/structure/table/rack,/obj/spawner/firstaid,/turf/simulated/floor/tiled/white,/area/template_noop)
"aM" = (/obj/spawner/junk,/obj/structure/bed/chair/office/light,/turf/simulated/floor/tiled/dark/brown_platform,/area/template_noop)
"aN" = (/obj/effect/decal/cleanable/mucus,/turf/simulated/floor/tiled/white,/area/template_noop)
"aP" = (/obj/structure/bed/padded,/obj/item/weapon/bedsheet/purple,/turf/simulated/floor/tiled/dark/brown_platform,/area/template_noop)
"aQ" = (/obj/item/weapon/beartrap,/turf/simulated/floor/tiled/dark/brown_platform,/area/template_noop)
"aR" = (/obj/spawner/closet,/turf/simulated/floor/tiled/dark/brown_platform,/area/template_noop)
"aS" = (/obj/spawner/junk,/obj/spawner/junk,/turf/template_noop,/area/template_noop)
"aT" = (/obj/effect/decal/cleanable/spiderling_remains,/obj/structure/table/standard{name = "plastic table frame"},/obj/machinery/reagentgrinder,/obj/spawner/oddities,/turf/simulated/floor/tiled/dark/brown_platform,/area/template_noop)
"aU" = (/obj/structure/table/rack,/obj/spawner/powercell,/obj/spawner/voidsuit,/obj/spawner/toolbox,/turf/simulated/floor/tiled/dark/brown_platform,/area/template_noop)
"aV" = (/obj/item/weapon/material/harpoon,/obj/effect/decal/cleanable/blood,/turf/simulated/floor/tiled/white,/area/template_noop)
"aW" = (/obj/structure/bed/padded,/obj/item/weapon/bedsheet/mime,/turf/simulated/floor/tiled/dark/brown_platform,/area/template_noop)
"aX" = (/obj/effect/window_lwall_spawn/reinforced,/turf/simulated/floor/plating,/area/template_noop)
"bd" = (/obj/effect/decal/cleanable/blood/drip,/turf/simulated/floor/tiled/white,/area/template_noop)
"bg" = (/obj/item/trash,/obj/effect/decal/cleanable/blood/drip,/turf/simulated/floor/tiled/white,/area/template_noop)

(1,1,1) = {"
afaoafafafafafafafafafafaf
afaaaaaaaaaaaaaaaaaaaaaaaf
afaaabacaaadaeaaahahaaakaf
afaaalamaaanaqaaahahaaakaf
afaaatauaaavauaaawauaaaaaf
afaaagaAagaNagajbdaxaaaiaf
afaaaVaJagaAbgbdayazaaaiaf
afaaaLagaaaaaaaBaaaaaaaaaf
afaaaaaCaaaDaEaFaGaHaaapaf
afaaaIahaaaKaMahacaPaaaraf
afaaaIaQaaaRaTaUahaWaaasaf
afaaaaaCaaaaaXaXaXaaaaaaaf
afafaoafaSafafafafafafafaf
"}
