"b" = (/obj/structure/flora/ausbushes/grassybush,/turf/template_noop,/area/template_noop)
"c" = (/obj/structure/flora/ausbushes/stalkybush,/turf/template_noop,/area/template_noop)
"d" = (/turf/template_noop,/area/template_noop)
"e" = (/obj/structure/flora/ausbushes/palebush,/turf/template_noop,/area/template_noop)
"f" = (/obj/structure/flora/ausbushes/ppflowers,/turf/template_noop,/area/template_noop)

(1,1,1) = {"
dddddddddddd
dddddddbdddd
ddddbddcdddd
dddddddddddd
ddcdbdddeddd
ddbddddfdbdd
dddddddddddd
"}
